abd	abd
abdim	abd
abdw	abd
abibi	abb
abn	abn
abnim	abn
abqekm	bqe
adm	adm
adwmh	adm
aeh	ane
aem	aem
aetw	aee
agpim	agp
agwdt	agd
aibd	abd
aibdh	abd
aieh	ane
aiei	aie
aieim	aie
aieit	aie
aieiwtw	aie
aierh	aer
aietw	ane
aiewm	aem
aigwd	agd
ail	ail
ailc	alc
aimc	amc
aimch	amc
aimwn	amn
ain	ain
ainh	ain
aini	ain
aink	ain
ainm	ain
ainn	ain
ainnh	ain
ainni	ain
ainw	ain
airwyim	ary
airy	ary
airyw	ary
aiswr	asr
aitr	atr
aitwr	atr
aiwm	aim
aizwn	azn
alipwt	alp
alp	alp
alpi	alp
alpim	alp
alwmwt	alm
amcy	mcy
amcyi	mcy
amcyim	mcy
amirh	amr
amitit	amt
amn	amn
amnm	amn
amr	amr
amrh	amr
amrnw	amr
amrt	amr
amrti	amr
amrw	amr
amt	amn
amwn	amn
amwr	amr
amwrh	amr
aper	aper
aperi	aper
aperit	aper
aperwiwt	aper
apiwn	api
apl	apl
arby	rby
arbyh	rby
arc	arc
arci	arc
arciwt	arc
arcwt	arc
ard	ard
argwn	argn
argwnim	argn
argwnit	argn
arih	ari
arwkh	ark
arwkim	ark
arwkwt	ark
aswr	asr
aswrim	asr
atiixs	ixs
av	avv
awepzw	aepz
awhb	ahb
awhbim	ahb
awhbwt	ahb
awklwsiih	akls
awlm	awl
awmh	amm
awmllwtm	amll
awmr	amr
awmrim	amr
awmrt	amr
awmwt	amm
awnim	awn
awpn	apn
awpntiwt	apn
awrh	awr
awrx	arx
awwirh	awr
awxdh	axd
awxzim	axz
awzniim	azn
axd	axd
axdim	axd
axdwt	axd
axr	axr
axraim	axr
axri	axr
axrihm	axr
axrim	axr
axriw	axr
axrt	axr
axrwt	axr
axt	axd
axwt	axi
axwz	axz
axwzim	axz
axz	axz
axzw	axz
azrxi	azrx
azwr	azr
azwri	azr
ba	bwa
babnim	abn
badm	adm
bagp	agp
bagpim	agp
bah	bwa
baim	bwa
bairwyi	ary
bamcy	mcy
bamcywt	mcy
bamwnh	amn
baneim	ane
banw	bwa
banxh	anx
barby	rby
barc	arc
barcwt	arc
barikwt	ark
basipt	asp
baw	bwa
bawlpnim	alp
bawpn	apn
bawpq	apq
bawrx	arx
bawwirh	awr
bawwirt	awr
bawzni	azn
baxd	axd
baxrwnh	axr
baxt	axd
bazkrwt	zkr
baznihm	azn
bazwr	azr
bbicwy	bcy
bbit	bit
bbitm	bit
bbitw	bit
bbivxwn	bvx
bbqyh	bqy
bbrit	bri
bbti	bit
bbtihm	bit
bbwz	bwz
bbxirt	bxr
bbxirwt	bxr
bbyih	byi
bbyiwt	byi
bbyli	byl
bcba	cba
bcd	cdd
bcdqt	cdq
bchriim	chr
bcibwr	cbr
bcirwp	crp
bclh	cll
bclxt	clx
bcpwn	cpn
bcwmt	cmt
bcwrh	cwr
bcwrk	crk
bcwwtwt	cwt
bcyr	cyr
bdbqwt	dbq
bdbr	dbr
bdbrih	dbr
bdbrii	dbr
bdbriw	dbr
bdibwrw	dbr
bdiqh	bdq
bdirtw	dwr
bdiwn	dwn
bdiwq	diq
bdixh	bdx
bdlnwt	bdl
bdmwt	dmh
bdqdqnwt	dqdq
bdqirwt	dqr
bdrg	drg
bdrieh	dre
bdriet	dre
bdrk	drk
bdrkn	drk
bdrkw	drk
bdrwm	drm
bdwar	dwr
bdwmh	dmi
bdyh	idy
bdytw	idy
bdywt	idy
bealh	eal
bebiywt	eby
bebwy	eby
bebwywt	eby
bedrh	edr
bee	eee
beidwr	edr
beirim	eir
beirwt	ert
beitwp	etp
beivh	ewv
beiywr	eyr
bekr	ekr
bekwnh	ekn
bekwnt	ekn
bekwnti	ekn
belb	elb
belvwn	elv
belwe	ele
belwet	ele
belwm	elm
bemal	emal
bemxh	emx
bemxt	emx
ben	enn
benh	eni
beni	eni
benim	eni
bent	eni
benwt	eni
benwtih	eni
beqv	eqv
beti	eni
betiqh	etq
bevx	evx
bevxi	evx
bevxim	evx
bewah	eai
bewliim	ewl
bewpv	epv
beyh	eyi
beyt	eyi
beytw	eyi
bgb	gbb
bgbw	gbb
bgdr	gdr
bgdrwt	gdr
bgibwen	gbe
bgibwi	gbi
bgil	gil
bginwi	gni
bgirwe	gre
bgll	gll
bglwi	gli
bglwt	gli
bgnwt	gni
bgswt	gss
bgwe	gwe
bgwrmim	grm
bgzynwt	gzy
bhchrwt	chr
bhetqpwt	eqp
bhgih	hgi
bhgzh	gzz
bhgzt	gzz
bhieg	neg
bhkrh	nkr
bhkrx	krx
bhlwwiitw	lwi
bhmek	mek
bhmekh	mek
bhnhgt	nhg
bhpgnh	pgn
bhpre	pre
bhptyh	pty
bhqerim	qer
bhriwn	hri
bhspdw	spd
bhtiixswt	ixs
bhtktewiwt	kte
bhtnhgwtm	nhg
bhtnhgwtw	nhg
bhtprywiwt	pry
bhtrgewt	rge
bhwcat	ica
bhwdyh	idy
bhwrh	hri
bhwwh	hwi
bhxlv	xlv
bhydr	ydr
bhymdtm	ymd
bibet	ibe
biciawt	ica
bicwr	bcr
bicwy	bcy
bidiyh	idy
bieibt	ieb
bihwdi	ihd
bihwdim	ihd
biiawe	iae
biiewmn	iem
bikwlt	ikl
bildwt	ild
bimi	iwm
bimim	iwm
bimin	imn
bin	bin
binihm	bin
binihn	bin
biniim	bin
bininw	bin
bintiim	bin
binw	bin
binwni	bin
biqe	bqe
biqeh	bqe
biqew	bqe
biqwr	bqr
biqwrtit	bqr
birwr	brr
biswdw	isd
bit	bit
bitm	bit
bitrwn	itr
bitw	bit
biva	bva
bivah	bva
bivwi	bva
bivwii	bva
bivwl	bvl
bivxwn	bvx
biwb	bib
biwm	iwm
biwmiim	iwm
biwtr	itr
bixd	ixd
bixs	ixs
bixsim	ixs
bki	bki
bkiph	kpp
bkir	bkr
bkirim	bkr
bkittw	ktt
bkiwwn	kwn
bkl	kll
bkla	kla
bkll	kll
bknst	kns
bkpr	kpr
bkspi	ksp
bkspwt	ksp
bktbh	ktb
bktbtw	ktb
bkwrx	krx
bkwt	bki
blb	lbb
blbd	lbd
blbm	lbb
blewn	len
blwwih	lwi
bmah	mai
bmair	awr
bmamc	amc
bmamrk	amr
bmatiim	mai
bmbnh	bni
bmbv	nbv
bmbva	bva
bmbxn	bxn
bmcb	icb
bmcpwn	cpn
bmdgm	dgm
bmdinh	dwn
bmdint	dwn
bmdinwt	dwn
bmdwiq	diq
bmdyi	idy
bmek	mek
bmeknta	ekn
bmentw	eni
bmepv	epv
bmepxtw	epx
bmeq	meq
bmerd	erd
bmerdi	erd
bmexq	exq
bmgmwt	gmm
bmgzr	gzr
bmhlk	hlk
bmhpk	hpk
bmidh	mdd
bmilwi	mli
bminhl	nhl
bminwnim	mni
bmitwn	mtn
bmiwxd	ixd
bmkrzim	krz
bmkwnit	kwn
bmkwnitw	kwn
bmlh	mll
bmlim	mll
bmlxmt	lxm
bmmelh	mel
bmmelt	mel
bmnzr	nzr
bmprc	prc
bmpwre	pre
bmqct	qcc
bmqrh	qri
bmqwm	qwm
bmqwmm	qwm
bmrkz	rkz
bmrpah	rpa
bmsgrt	sgr
bmsgrtw	sgr
bmsgrwt	sgr
bmsibt	sbb
bmsy	nsy
bmsym	nsy
bmtqpt	tqp
bmwbn	bin
bmwcai	ica
bmwchr	chr
bmwnxim	nwx
bmwqd	iqd
bmwtm	mwt
bmwtw	mwt
bmwwt	mwt
bmwymdwtw	ymd
bmxir	mxr
bmxlwqt	xlq
bmxnh	xni
bmxnwt	xni
bmxqr	xqr
bmycr	ycr
bmyeh	yei
bmyin	yin
bmymqi	ymq
bmynq	ynq
bmyrb	yrb
bmyrkt	yrk
bmywrpl	yrpl
bmzrx	zrx
bnawm	nam
bneia	nea
bnicxwn	ncx
bnicxwnw	ncx
bnigwd	ngd
bniin	bni
bnisiwn	nsi
bnpeh	npe
bnqwdh	nqd
bnsiyh	nsy
bnviih	nvi
bnwea	nea
bnwi	bni
bnwsx	nsx
bnwwh	nwi
bnxt	nwx
bpcwyim	pcy
bpiqwd	pqd
bpni	pni
bpnih	pni
bpnik	pni
bpniw	pni
bpreh	pre
bpret	pre
bprich	prc
bprs	prs
bprv	prv
bptx	ptx
bpwlxn	plx
bpxwt	pxt
bpyilwt	pyl
bpym	pym
bqbwct	qbc
bqeiiw	qei
bqhl	qhl
bqic	qic
bqlwt	qll
bqpicwt	qpc
bqrb	qrb
bqriat	qra
bqristn	qrs
bqrn	qrn
bqryim	qry
bqvip	qvp
bqvy	qvy
bqwde	qde
bqwei	qei
bqwmc	qmc
bqy	bqy
bqyh	bqy
brae	rae
braeh	rae
braeit	rae
braeith	rae
braew	rae
braewt	rae
braiwn	rai
brbim	rbb
brcinwt	rcn
brcipwt	rcp
brcwni	rci
brcwyh	rcy
brcwyt	rcy
brcx	rcx
breimt	rem
bret	ret
bretwt	ret
brgewt	rge
brglw	rgl
briah	bra
briawt	bra
brich	rwc
brkwt	brk
brwbm	rbb
brwr	brr
brwxh	rwx
brxbh	rxb
brxbi	rxb
brxbt	rxb
brxwb	rxb
brxwbwt	rxb
bsgnwn	sgnn
bsisiim	bsis
bsiwm	sim
bsiwr	sir
bsiwy	siy
bsk	swk
bskinim	skn
bsmim	smm
bsmli	sml
bsmlim	sml
bspq	spq
bspr	spr
bsprw	spr
bsqrim	sqr
bswgih	swg
bswp	swp
bswpw	swp
btawnt	ani
btbiyh	tby
btbwnh	bin
btbwst	bws
btbwstw	bws
btediri	edr
btgwbh	gwb
bthlik	hlk
bti	bit
btimhwn	tmh
btmikh	tmk
btnai	tni
btnwyh	nwy
btnwytw	nwy
btqcib	qcb
btqipwt	tqp
btqriwt	qri
btqwph	qwp
btqwpt	nqp
btwar	tar
btwcawt	ica
btwk	twk
btwkki	twk
btwknit	tkn
btwldwt	ild
btwqpnwt	tqp
btxilh	xll
btxilt	xll
btxwm	txm
btxwmi	txm
btxwmim	txm
bvipwl	vpl
bvipwlw	vpl
bviwl	vil
bvrm	vrm
bvwhr	vhr
bvwx	bvx
bvwxh	bvx
bvwxim	bvx
bvym	vym
bvymim	vym
bvynh	vyn
bwaw	bwa
bwcy	bcy
bwdd	bdd
bwddim	bdd
bwddwt	bdd
bwet	bwe
bwlvt	blv
bwqywt	bqy
bwwdai	wdi
bwwdawt	wda
bwwikwx	wkx
bwwitwr	wtr
bwwydt	wyd
bwwyidt	wyd
bxbr	xbr
bxbwrt	xbr
bxekh	xek
bxii	xii
bxiim	xii
bxiiw	xii
bxinwk	xnk
bxirwt	bxr
bxiwk	xik
bxlil	xll
bxlqim	xlq
bxlqn	xlq
bxmdh	xmd
bxqirh	xqr
bxqlawt	xql
bxswt	xsi
bxvipt	xvp
bxwde	xde
bxwdeim	xde
bxwg	xwg
bxwkmh	xkm
bxwmrim	xmr
bxwsr	xsr
bxzqt	xzq
bxzrh	xzr
bybr	ybr
bybwdwt	ybd
bycb	ycb
bycm	ycm
bycmawt	ycm
bycmm	ycm
byd	byd
bydinwt	ydn
byerwt	yer
byewrim	yer
byicwmh	ycm
byicwmw	ycm
byiirh	yir
byin	yin
byinh	yin
byini	yin
byiniim	yin
byiniw	yin
byiqr	yqr
byir	yir
byitwn	ytt
byitwnaim	ytt
byitwnim	ytt
byitwnwt	ytt
byiwt	byi
byl	byl
byli	byl
bylt	byl
bylwt	byl
bymdh	ymd
bymwd	ymd
bynp	ynp
byqbwt	yqb
byqbwtiw	yqb
byrb	yrb
byrbi	yrb
byrbim	yrb
byrkw	yrk
byt	ytt
bytid	ytd
bywbdi	ybd
bywcr	ycr
bywd	ywd
bywlm	ylm
bywlmnw	ylm
bywrmh	yrm
byzh	yzz
byzrt	yzr
bzhirwt	zhr
bzikrwnw	zkr
bzkwiwt	zki
bzkwt	zki
bzmn	zmn
bzyqwt	zyq
catn	ica
cba	cba
cbai	cba
cbaiim	cba
cbait	cba
cbaiwt	cba
cbywni	cby
cbywnit	cby
cd	cdd
cddi	cdd
cdn	cdd
cdqh	cdq
chbhb	chb
cibwr	cbr
cibwri	cbr
cibwriim	cbr
cibwrit	cbr
ciint	cin
cir	cir
civwv	cvv
ciwni	cin
ciwrit	cir
ciww	cwi
clil	cll
clmi	clm
cma	cma
cpirwt	cpr
cpwiim	cpi
cpwn	cpn
crh	crr
crik	crk
crikh	crk
crikim	crk
crikwt	crk
crw	cwr
cwdq	cdq
cwmcm	cmcm
cwrk	crk
cwwti	cwt
cwwtwt	cwt
cwwx	cwx
cwydt	cyd
cxwq	cxq
cxwt	cxx
cyd	cyd
cydw	cyd
cyir	cyr
cyirim	cyr
dag	dag
dbqit	dbq
dbr	dbr
dbri	dbr
dbrii	dbr
dbrim	dbr
dbriw	dbr
dge	dge
dgl	dgl
dglw	dgl
dgnim	dgn
dibr	dbr
dibrti	dbr
dibwr	dbr
diin	dwn
dikwi	dki
din	dwn
dir	dir
dirwt	dwr
dirwtihm	dwr
diwn	dwn
diwwx	dwx
diwwxh	dwx
diwwxim	dwx
diwwxw	dwx
dmiwnw	dmi
dmwt	dmi
dn	dwn
dqh	dqq
dqrw	dqr
dqwt	dqq
drbwn	drbn
driet	dre
drk	drk
drki	drk
drkihm	drk
drkim	drk
drwm	drm
dwbr	dbr
dwbrt	dbr
dwgmawt	dgm
dwgmh	dgm
dwmh	dmi
dwmim	dmi
dwwqa	dwq
dwwx	dwx
dwx	dwx
dwxp	dxp
dwxpim	dxp
dwxqwt	dxq
dxiph	dxp
dxipwt	dxp
dxqw	dxq
dxwpwt	dxp
dyt	idy
dyti	idy
dywt	idy
eaeti	ane
eaibdw	abd
eaieti	ane
eain	ain
eainm	ain
eainn	ain
eainw	ain
eaiperw	aper
eairwyi	ary
eairwyim	ary
eal	eal
ealh	eal
ealnw	eal
ealw	eal
ealwt	eal
eamnm	amn
eanei	ane
eaneim	ane
eawepz	aepz
eawmrim	amr
eaxd	axd
eaxri	axr
eaxritw	axr
eaxt	axd
eba	bwa
ebatr	atr
ebbit	bit
ebbwa	bwa
ebdrk	drk
ebebt	ebeb
ebelwe	ele
ebenwt	eni
ebhcbyh	cby
ebhkrx	krx
ebicyw	bcy
ebin	bin
ebiqew	bqe
ebirtw	bir
ebith	ebt
ebkl	kll
ebkla	kla
ebktbtk	ktb
ebmnzr	nzr
ebmsgrth	sgr
ebraew	rae
ebrh	ebr
ebrwr	brr
ebswpw	swp
ebwddim	bdd
ebwy	eby
ebwywt	eby
ebybr	ybr
ebyh	eby
ebyim	eby
ebyli	byl
ebyniin	ynin
ebyqbwtihm	yqb
ebyqbwtiw	yqb
ebytid	ytd
ecpwi	cpi
ecyirim	cyr
edd	edd
ednh	dwn
edqr	dqr
edwmh	dmi
edwt	edi
ee	eee
eebh	ebi
eegb	egb
eeh	eeh
eehh	ehh
eei	eee
eeinnti	enn
eelwet	ele
eelxw	elx
eemyti	emy
eerdw	erd
eerr	err
eerrh	err
eet	eee
eevpw	evp
egb	egb
egilth	gli
egrt	egr
egrti	egr
egrtit	egr
ehaibh	aib
ehbanw	bwa
ehbiyw	nby
ehcdq	cdq
ehcilw	ncl
ehclix	clx
ehewah	eai
ehgiyw	ngy
ehhclxh	clx
ehhcyh	icy
ehih	hih
ehiiti	hih
ehild	ild
ehith	hii
ehiw	hii
ehiwm	iwm
ehixidim	ixd
ehknst	kns
ehkwl	kll
ehmlich	mlc
ehmmelh	mel
ehmmsd	msd
ehmspd	spd
ehmxqr	xqr
ehnpe	npe
ehnxit	nxt
ehpic	pwc
ehpicw	pwc
ehpkh	hpk
ehpridh	prd
ehqim	qwm
ehrah	rai
ehrge	rge
ehsitw	swt
ehsiwr	sir
ehskswk	sksk
ehstwbb	sbb
ehtaim	tam
ehtiiebh	ieb
ehtiimrw	imr
ehtiixs	ixs
ehtmwdd	mdd
ehtngd	ngd
ehtngdh	ngd
ehtnhl	nhl
ehtnhlw	nhl
ehtprsm	prsm
ehtpryw	pry
ehtqriwt	qri
ehtrgewt	rge
ehtwylt	iyl
ehwbsw	bws
ehwciaw	ica
ehwdh	idi
ehwemw	eim
ehwer	eir
ehwlid	ild
ehwlidw	ild
ehwpc	pwc
ehwreyw	rey
ehwvbyh	vby
ehwvl	nvl
ehxbrh	xbr
ehxiim	xii
ehxtwm	xtm
ehxziq	xzq
ehxzir	xzr
ehybirh	ybr
ehydipw	ydp
ehymid	ymd
ehywlm	ylm
ehzdrz	zrz
eibia	bwa
eibqew	bqe
eibva	bva
eicaw	ica
eicbiy	cby
eiclixw	clx
eicrw	icr
eidy	idy
eiebw	ieb
eieh	eee
eielimw	elm
eiemiy	emy
eietmew	eme
eiexrr	exrr
eigrh	egr
eihih	hih
eihiw	hii
eihwdim	ihd
eiica	ica
eiik	eik
eiikt	eik
eiimek	mek
eiimny	mny
eiiycrw	ycr
eikbsw	kbs
eiklw	ikl
eikny	ekny
eilkdw	lkd
eilmh	elm
eilx	elx
eime	eme
eimeh	eme
eimwe	eme
eimwtw	mwt
einh	eni
eini	enn
einnw	enn
eir	eir
eirdw	ird
eiri	eir
eiribh	rib
eirw	iri
eirwt	ert
eirwti	ert
eirwtim	ert
eisd	isd
eiskim	skm
eispr	spr
eitbrr	brr
eitptx	ptx
eitrwm	trm
eiwsgr	sgr
eiwtr	ntr
eiwwi	ewi
eixi	eix
eixzq	xzq
eixzr	exzr
eiybwd	ybd
eiyd	iyd
eiyrti	eyr
eiysiq	ysq
eiywl	eyl
eiywr	eyr
ekamwr	amr
ekbwt	ekb
ekins	kns
ekirim	ekr
ekiwm	iwm
ekix	ekx
ekixh	ekx
eknim	ekn
ekny	ekny
eknyw	ekny
ekr	ekr
ektb	ktb
ektbt	ktb
ekwlm	kll
ekwlnw	kll
ekwlw	kll
ekwnt	ekn
ekwnwt	ekn
ekwwntw	kwn
ekyt	ytt
elawrk	ark
elaxr	axr
elbew	lbe
elcd	cdd
eldbrim	dbr
eldim	eld
eldytw	idy
elewm	ele
eliei	ele
elieit	ele
elili	ell
eliliwt	ell
elimdt	lmd
elivh	elv
elivim	elv
elix	elx
elixim	elx
elm	elm
elmrwt	mri
elpni	pni
elpxwt	pxt
elqx	lqx
elvim	elv
elwe	ele
elweh	ele
elwet	ele
elwm	elm
elx	elx
elxh	elx
elytim	ytt
emal	emal
emalh	emal
emali	emal
emalit	emal
emalni	emal
emaws	mas
embia	bwa
embin	bin
emdiniwt	dwn
emdint	dwn
emewt	eme
emihr	mhr
emim	emi
emirt	emr
emktbim	ktb
emmeik	mek
emn	emn
emndim	ndi
empr	prr
emriyim	rwy
emrkz	rkz
emrn	emr
emrniim	emr
emrnim	emr
emrniwt	emr
emsrh	msr
emwbn	bin
emwnh	emn
emwnim	emn
emwymdm	ymd
emx	emx
emy	emy
emybr	ybr
emynqi	ynq
emyti	emy
emywlm	ylm
enah	ena
enamr	amr
enamrh	amr
enbxrt	bxr
enbxrw	bxr
endrs	drs
eneal	eal
enearw	ear
enelx	elx
enemtw	nem
enepvw	epv
engrm	grm
engy	ngy
enh	eni
eni	eni
eniclw	ncl
enihl	nhl
enihlw	nhl
enihm	eni
eniih	eni
eniim	eni
enim	eni
enish	nsi
enisw	nsi
enit	eni
enmca	mca
enmek	mek
enmsrh	msr
enpcy	pcy
enpcyw	pcy
enpl	npl
enprdnw	prd
enpsq	psq
enqly	qly
enqryw	qry
enrath	rai
enrcx	rcx
enrcxw	rcx
enrqmh	rqm
ensyti	nsy
enti	eni
entiim	eni
entpst	tps
entyd	tyd
enviitw	nvi
enwdy	idy
enwea	nea
enweah	nea
enwi	eni
enwih	eni
enwrh	iri
enwrth	iri
enwrw	iri
enwsy	nsy
enwt	eni
enwtr	itr
enwtrw	itr
enxed	xed
enxl	nxl
eny	nwy
enyrkh	yrk
enzrqh	zrq
epipwn	epp
epl	epl
epqdh	pqd
epqid	pqd
epret	pre
eprsmh	prsm
eprsmw	prsm
eprxh	prx
eptii	epi
eptxnw	ptx
epwrsmh	prsm
epym	pym
eqbyh	qby
eqcrh	qcr
eqdm	qdm
eqibl	qbl
eqiblh	qbl
eqiblw	qbl
eqicwnim	qci
eqiim	qwm
eqiimwt	qwm
eql	qll
eqr	eqr
eqra	qra
eqrn	eqr
eqrnit	eqr
eqrnwt	qrn
eqv	eqv
eqwrh	qri
eqwyh	eqy
er	err
erah	rai
eraw	rai
ercw	rwc
ercx	rcx
erge	rge
erid	erd
erirwtit	err
erwb	rbb
erwbm	rbb
esblw	sbl
esibkh	sbk
esikwiw	ski
esiwrim	swr
esmlim	sml
eswg	swg
eswprh	spr
etdlnim	edl
eteim	eim
etgiy	ngy
etgwbwt	gwb
ethih	hii
eti	eni
etiim	eni
etklwl	kll
etnwyt	nwy
etqcib	qcb
etrmw	trm
ettyqe	yqe
etwebim	ieb
etwk	twk
etwmkiw	tmk
etxweh	xwe
evby	vby
eviplw	vpl
evwavaw	vava
evwt	evi
evxi	evx
ew	yei
ewab	eab
ewah	eai
ewal	eal
ewalim	eal
ewalt	eal
ewapim	eap
ewapwt	eap
ewb	ewb
ewbh	ebi
ewliim	ewl
ewll	ell
ewlp	elp
ewlpim	elp
ewlxim	elx
ewlxnwt	elx
ewmrim	emr
ewnh	eni
ewni	eni
ewnim	eni
ewnwt	eni
ewpv	epv
ewq	ewq
ewreim	ere
ewrh	ewr
ewrrt	err
ewrt	ewr
ewtp	etp
ewvr	evr
ewvrim	evr
ewwh	ewi
ewwim	ewi
ewxri	exr
ewxrrw	exrr
exe	xwe
exlpw	xlp
exlq	xlq
exlqm	xlq
exr	exr
exrwrh	exrr
exvp	xvp
exwr	exr
exwrim	exr
exwwh	xwi
exwwiti	xwi
eybr	ybr
eybrh	ybr
eybrw	ybr
eydiin	ydi
eyeh	yei
eyeth	yei
eyewi	yei
eyh	eyi
eyiriit	yir
eylihm	yli
eylwl	yll
eylwlim	yll
eylwlwt	yll
eyrkw	yrk
eyrwriitiwt	eyrr
eyrwtihm	eyr
eytiim	eyi
eywd	ywd
eyweim	yei
eywn	eyn
eywrr	ywr
eywt	eyi
ezkr	zkr
ezwr	ezr
gawlh	gal
gawnwt	gai
gbr	gnb
gbwh	gbh
gbwhh	gbh
gbwlwt	gbl
gbwrh	gbr
gbyt	gby
gdirwt	gdr
gdl	gdl
gdlim	gdl
gdweh	gde
gdwl	gdl
gdwlh	gdl
gdwlim	gdl
gem	gem
gidp	gdp
gidwp	gdp
gieh	nge
giis	gis
gilh	gli
giliti	gli
ginwi	gni
girwem	gre
glidh	gld
glwih	gli
grgrim	grgr
grmw	grm
grr	grr
gwbrwt	gbr
gwdl	gdl
gwlm	glm
gwptw	gwp
gwrew	gre
gwrl	grl
gwrlm	grl
gwrm	grm
gwrmim	grm
gwrmt	grm
gwrr	grr
gzr	gzr
gzyni	gzy
gzynwt	gzy
habdwt	abd
habn	abn
hadir	adr
hadwmwt	adm
haeimh	aem
haemh	aem
hahdh	ahd
haibh	aib
haie	aie
haiewr	aer
haikrim	akr
haimtniim	aim
hairwyim	ary
haiwmh	aim
hakzbh	kzb
hamcyim	mcy
hamnwti	amn
hamt	amn
hamwnh	amn
haneim	ane
haper	aper
haperwt	aper
haplh	apl
harbyim	rby
harc	arc
harcit	arc
harciwt	arc
harcwt	arc
hargwn	argn
harwkh	ark
hasirim	asr
hatr	atr
hawcr	acr
hawib	aib
hawmr	amr
hawr	awr
hawtiwt	awt
haxd	axd
haxiwt	axi
haxrim	axr
haxriwt	axr
haxrwn	axr
haxrwnh	axr
haxrwnim	axr
haxrwnwt	axr
haxrwt	axr
haxt	axd
hba	bwa
hbah	bwa
hbaim	bwa
hbawt	bwa
hbh	ihb
hbhir	bhr
hbhirwt	bhr
hbia	bwa
hbicwy	bcy
hbin	bin
hbiqwr	bqr
hbiqwrt	bqr
hbit	bit
hbiv	nbv
hbivwi	bva
hbivwx	bvx
hbivxwn	bvx
hbiy	nby
hbkirh	bkr
hbkirim	bkr
hbnh	bwn
hbriqh	brq
hbrit	bri
hbvixh	bvx
hbwlvim	blv
hbwqr	bqr
hbwz	bwz
hbxinh	bxn
hbxinw	bxn
hbxirh	bxr
hbxirwt	bxr
hbyih	byi
hbyiwt	byi
hcba	cba
hcbait	cba
hcbiyw	cby
hcd	cdd
hcdqh	cdq
hchriim	chr
hchrim	chr
hchrt	chr
hcib	icb
hcibwr	cbr
hcibwri	cbr
hcibwrit	cbr
hcidh	cdd
hcinwrwt	cnr
hcirwp	crp
hcit	ict
hciy	icy
hciyh	icy
hclix	clx
hclixh	clx
hclxh	clx
hclxth	clx
hcpwn	cpn
hcpwniwt	cpn
hcrim	cwr
hcvrpw	crp
hcw	cwi
hcwrk	crk
hcwynim	cyn
hcxiqh	cxq
hcyirim	cyr
hcyirwt	cyr
hcyt	icy
hcywt	icy
hdbq	dbq
hdbr	dbr
hdbrim	dbr
hdge	dge
hdgie	dge
hdgl	dgl
hdglim	dgl
hdgmti	dgm
hdgnim	dgn
hdhim	dhm
hdibwr	dbr
hdin	dwn
hdiwn	dwn
hdiwnim	dwn
hdiwr	dwr
hdiwwxim	dwx
hdmwt	dmi
hdn	dwn
hdrgti	drg
hdrk	drk
hdrkim	drk
hdrweh	dre
hdrwm	drm
hdwagim	dag
hdwar	dwr
hdwbrt	dbr
hdwgmh	dgm
hdwpn	dpn
hdwxqwt	dxq
hdyt	idy
hdywt	idy
heair	ear
heairw	ear
healh	eal
hear	ear
hebwy	eby
hedwlh	edl
heeim	eee
hegiah	egi
heib	ewb
heiikim	eik
heimwe	eme
heiqwp	eqp
heirim	eir
heirwt	ert
hekil	ekl
hekixh	ekx
hekn	ekn
heknh	ekn
hekr	ekr
hekwnwt	ekn
heliei	ele
heliliwt	ell
helim	elm
helmh	elm
helmwt	elm
helvwnwt	elv
helwm	elm
hemal	emal
hemalit	emal
hemiy	emy
hemrn	emr
hemrnim	emr
hemrniwt	emr
hemvt	emv
hemw	eim
henah	ena
henh	eni
heni	eni
heniih	eni
henim	eni
henti	eni
hepiy	epy
hepwi	epi
hepy	epy
heqph	eqp
heqptw	eqp
her	err
herirnim	err
hetdlw	edl
hetiih	eti
hetiikw	eik
hetiikwt	eik
hetme	eme
hetmeh	eme
hetmy	emy
hetnh	eni
hevx	evx
hevxim	evx
hewah	eai
hewllim	ell
hewlxim	elx
hewlxn	elx
hewmr	emr
hewnim	eni
hewpkin	epk
hewrrt	err
hewtpim	etp
hewvr	evr
hewvrim	evr
hewwiwn	ewi
hexitwt	ext
hexrwr	exrr
hexwrh	exr
heyr	eyr
hgbwhh	gbh
hgbwl	gbl
hgbwrh	gbr
hgdir	gdr
hgdrh	gdr
hgdrwt	gdr
hgdwl	gdl
hgdwlh	gdl
hgdwlim	gdl
hgdwlwt	gdl
hgib	gwb
hgie	nge
hgieh	nge
hginwi	gni
hgiwni	hgi
hgiwniim	hgi
hgiwnit	hgi
hgiy	ngy
hgiyh	ngy
hgiyw	ngy
hglil	gll
hgrim	gwr
hgryin	gryn
hgwe	gwe
hgweim	gwe
hgwnh	hgn
hgwpim	gwp
hgwrmim	grm
hgwwiih	gwi
hgynw	ngy
hgyti	ngy
hgzynwt	gzy
hhaemwt	aem
hhbdl	bdl
hhcbyh	cby
hhcyh	icy
hhdrim	hdr
hheqph	eqp
hhetkrwt	ekr
hhewwah	ewi
hhgdrh	gdr
hhgirh	hgr
hhgyh	ngy
hhigiwn	hgi
hhipk	hpk
hhitr	ntr
hhkrxi	krx
hhlm	hlm
hhlwwiih	lwi
hhmwn	hmi
hhmwniim	hmi
hhmwnim	hmi
hhnhgwt	nhg
hhnxh	nwx
hhpqr	pqr
hhsbr	sbr
hhsdr	sdr
hhspdim	spd
hhtamh	tam
hhtamwt	tam
hhtaxdwt	axd
hhtmqdwt	mqd
hhtmrdwt	mrd
hhtngdwt	ngd
hhtngewiwt	nge
hhtnkrwt	nkr
hhtprywiwt	pry
hhtptxwt	ptx
hhtpwrrwt	prr
hhtqph	tqp
hhtrgewt	rge
hhtxlh	xll
hhwlkt	hlk
hhwlkwt	hlk
hhwn	hwn
hhwrh	hri
hhwrim	hri
hhwwh	hwi
hhwwih	hwi
hhyrmh	yrm
hhzdmnwt	zmn
hiawt	iai
hibe	ibe
hicr	icr
hicy	icy
hidiyh	idy
hidwyh	idy
hidy	idy
hieibh	ieb
hieimwt	eim
higiwn	hgi
hih	hih
hihwdi	ihd
hihwdiim	ihd
hihwdim	ihd
hihwdit	ihd
hihwdiwt	ihd
hiicwg	icg
hiih	hii
hiinw	hii
hiit	hii
hiiti	hih
hiitkn	tkn
hikrwt	nkr
hikw	nki
hikwl	ikl
hikwlim	ikl
hikwlt	ikl
hild	ild
himim	iwm
himin	imn
himniim	imn
himnit	imn
himwr	hmr
hiqrh	iqr
hircxw	rcx
hirib	rib
hiribh	rib
hiriwt	iri
hirqwt	irq
hiss	hss
hith	hih
hitr	itr
hitri	ntr
hitrwn	itr
hivl	nvl
hiw	hih
hiwcaim	ica
hiwdyim	idy
hiwm	iwm
hiwmi	iwm
hiwt	hih
hiwti	hii
hiwtr	itr
hixid	ixd
hixidh	ixd
hixidim	ixd
hixsim	ixs
hixswt	ixs
hiydrwt	ydr
hkab	kab
hkbd	kbd
hkbdwt	kbd
hkbie	kbe
hkbish	kbs
hkhwnh	khn
hkhwt	khh
hkibwe	kbe
hkipwt	kpp
hkl	kll
hklklit	klkl
hkll	kll
hklli	kll
hkllit	kll
hknish	kns
hknsiih	kns
hknst	kns
hknwtihn	kwn
hkpph	kpp
hkpr	kpr
hkriz	krz
hkrtw	nkr
hkrwkh	krk
hkrzwt	krz
hksp	ksp
hkspim	ksp
hktbh	ktb
hktibh	ktb
hktwb	ktb
hktwbt	ktb
hkwabt	kab
hkwbe	kbe
hkwl	kll
hkwllni	kll
hkwtb	ktb
hkwtrt	ktr
hkwwnt	kwn
hkwzbt	kzb
hlawmi	lam
hlawmiim	lam
hlawmit	lam
hlawmiwt	lam
hlb	lbb
hlbn	lbn
hlewn	len
hlewni	len
hlhbh	lhb
hlikwd	lkd
hlkh	hlk
hlknw	hlk
hlkw	hlk
hlqx	lqx
hlwmdim	lmd
hlwwih	lwi
hlwwiih	lwi
hlwxmim	lxm
hmabq	abq
hmah	mai
hmamc	amc
hmaminh	amn
hmamn	amn
hmamr	amr
hmamrim	amr
hmawrgn	argn
hmawrgnim	argn
hmazniim	azn
hmbieh	bwe
hmbnim	bni
hmbqet	bqe
hmbwgr	bgr
hmbwlbl	blbl
hmbwvlim	bvl
hmcbiy	cby
hmcbiyim	cby
hmcia	mca
hmciawt	mca
hmcvv	cvv
hmcwqh	cwq
hmcwqwt	cwq
hmcwvvwt	cvv
hmdinh	dwn
hmdini	dwn
hmdiniwt	dwn
hmdinwt	dwn
hmdy	idy
hmebr	ebr
hmeik	mek
hmekntawt	ekn
hmekt	mek
hmelim	elm
hmeme	eme
hmepiyim	epy
hmepv	epv
hmepviim	epv
hmepvim	epv
hmepxh	epx
hmeqiph	eqp
hmeql	eql
hmert	ert
hmevr	evr
hmevrh	evr
hmewlm	elm
hmewlmim	elm
hmewxrrt	exrr
hmexq	exq
hmexqim	exq
hmgdl	gdl
hmgnh	gni
hmgnnh	gnn
hmgwbet	gbe
hmhgrim	hgr
hmhwll	hll
hmhwmwt	hwm
hmibxn	bxn
hmidy	idy
hmim	mim
hminhlit	nhl
hmiwent	ien
hmiwmnwt	imn
hmiwxdim	ixd
hmiwxl	ixl
hmiwxlt	ixl
hmkr	mkr
hmkwn	kwn
hmkwniwt	kwn
hmkwyrt	kyr
hmlch	mlc
hmlh	mll
hmlim	mll
hmlwklkt	lklk
hmlxmh	lxm
hmmelh	mel
hmmelti	mel
hmmsd	msd
hmmwekt	mek
hmmwnh	mnh
hmmwnim	mni
hmmwqmt	mqm
hmmwsdt	msd
hmnhigim	nhg
hmnhl	nhl
hmnsh	nsi
hmnwkrt	nkr
hmnwsh	nsi
hmnwxwt	nwx
hmnzr	nzr
hmplgh	plg
hmplgwt	plg
hmprc	prc
hmpriy	pry
hmpwreim	pre
hmqblim	qbl
hmqly	qly
hmqrh	qri
hmqwblim	qbl
hmqwmi	qwm
hmqwmiim	qwm
hmqwrb	qrb
hmqwrit	qwr
hmqwrwt	qwr
hmrkwl	rkl
hmrkzi	rkz
hmrkzim	rkz
hmrkzit	rkz
hmrqxt	rqx
hmrtqt	rtq
hmrwbim	rbi
hmrwbwt	rwb
hmrwxq	rxq
hmskn	skn
hmskt	msk
hmspqim	spq
hmsqnh	nsq
hmsqnwt	nsq
hmswgl	sgl
hmswrti	msr
hmsxri	sxr
hmsy	nsy
hmsydn	syd
hmt	mwt
hmtgbet	gbe
hmtgwrrim	gwr
hmtim	mwt
hmtkwwn	kwn
hmtndbim	ndb
hmtngd	ngd
hmtngewt	nge
hmtnkrim	nkr
hmtnkrt	nkr
hmtprcim	prc
hmtprqt	prq
hmtpryim	pry
hmtqeim	qei
hmtremim	rem
hmtrxe	rxe
hmtwn	mtn
hmtyd	tyd
hmtymqim	ymq
hmtyniint	ynin
hmvir	mvr
hmvplt	vpl
hmvrh	nvr
hmvwrpim	vrp
hmwbilim	ibl
hmwdywt	idy
hmwebim	ieb
hmweg	neg
hmwel	mel
hmwelim	mel
hmwgblt	gbl
hmwkerim	ker
hmwknim	kwn
hmwld	ild
hmwldt	ild
hmwmxim	mxi
hmwmxiwt	mxi
hmwni	hmi
hmwnim	hmi
hmwnpqim	npq
hmwnx	nwx
hmwnyim	mny
hmwqdmwt	qdm
hmwret	ire
hmwrge	rge
hmwrkbt	rkb
hmwsri	isr
hmwsrit	isr
hmwwt	mwt
hmwwtr	wtr
hmwx	mxx
hmwycwt	iyc
hmwyd	iyd
hmwymd	ymd
hmwymdim	ymd
hmwymdt	ymd
hmwysqim	ysq
hmwzkrim	zkr
hmxir	mxr
hmxlwqt	xlq
hmxnh	xni
hmxqr	xqr
hmxswr	xsr
hmycmwt	ycm
hmycr	ycr
hmycrim	ycr
hmyeh	yei
hmygl	ygl
hmyidh	myd
hmyniinim	ynin
hmyrb	yrb
hmyrbit	yrb
hmyrkh	yrk
hmyrkt	yrk
hmysiqim	ysq
hmysiqwt	ysq
hmyvh	yvi
hmyvim	myv
hmywniinim	yni
hmzl	mzl
hmzrx	zrx
hnabqim	abq
hnamn	amn
hnamrim	amr
hnawm	nam
hnbia	nba
hnbxr	bxr
hnbxrt	bxr
hncib	ncb
hncxi	ncx
hndwn	dwn
hneal	eal
hneia	nea
hneiawt	nea
hneq	neq
hnhgh	nhg
hnicb	icb
hnisiwnwt	nsi
hnkwnim	kwn
hnmcat	mca
hnmek	mek
hnmekwt	mek
hnmny	mny
hnmrcim	mrc
hnmwk	nmk
hnmwkh	nmk
hnpe	npe
hnpei	npe
hnplaim	pla
hnpt	nwp
hnpvr	pvr
hnqmh	nqm
hnsibwt	sbb
hnsiyh	nsy
hnsyrim	syr
hntwnim	ntn
hnwea	nea
hnwgy	ngy
hnwhg	nhg
hnwkxi	nkx
hnwkxim	nkx
hnwkxit	nkx
hnwra	ira
hnwrah	ira
hnwsxh	nsx
hnwvim	nvi
hnwxwt	nwx
hnwyr	nyr
hnxeim	nxe
hnxiewt	nxe
hnxih	nxi
hnxwc	nxc
hnxwch	nxc
hnyeh	yei
hnyimwt	nym
hnyr	nyr
hnyrkim	yrk
hnzirh	nzr
hnzirwt	nzr
hpcwy	pcy
hpcwyim	pcy
hpernim	per
hpgnh	pgn
hpgnwt	pgn
hpgwy	pgy
hpic	pwc
hpigwyim	pgy
hpk	hpk
hpkw	hpk
hpla	pla
hplieh	ple
hplivim	plv
hpnim	pnm
hpnimi	pnm
hpqiyw	pqy
hpre	pre
hpreiwt	pre
hpriy	pry
hprswm	prsm
hpsqh	psq
hptgm	ptgm
hptixh	ptx
hptiyw	pty
hptrwn	ptr
hptrwnwt	ptr
hptwx	ptx
hpvie	pve
hpwey	pey
hpwkh	hpk
hpwqdwt	pqd
hpwyl	pyl
hpwylim	pyl
hpxwt	pxt
hpyilh	pyl
hpyilim	pyl
hpym	pym
hpyr	pyr
hqbr	qbr
hqcrwt	qcr
hqdie	qde
hqdm	qdm
hqeh	qei
hqeim	qei
hqer	qer
hqewr	qer
hqewt	qei
hqhilh	qhl
hqhl	qhl
hqicwnit	qcn
hqiimt	qwm
hqim	qwm
hqmt	qwm
hqnswt	qns
hqpdti	qpd
hqpid	qpd
hqpidw	qpd
hqrb	qrb
hqrh	qrr
hqriah	qra
hqrin	qrn
hqrn	qrn
hqrnwt	qrn
hqrwbh	qrb
hqrwbim	qrb
hqsm	qsm
hqvn	qvn
hqvnh	qvn
hqwdmwt	qdm
hqwr	qrr
hqwrbnwt	qrb
hqyrh	qyr
hr	hrr
hrae	rae
hraei	rae
hraewn	rae
hraewnh	rae
hraiih	rai
hrawi	rai
hrawiim	rai
hrb	rbb
hrbbwt	rbb
hrbh	rbi
hrbim	rbb
hrbnim	rbb
hrbw	rbi
hrcim	rwc
hrcip	rcp
hrcwn	rci
hrcwyh	rcy
hrcx	rcx
hrdwd	rdd
hrewiwt	rei
hrey	rey
hrge	rge
hrgeh	rge
hrgeti	rge
hrgetm	rge
hrgewt	rge
hrgil	rgl
hrgy	rgy
hrhwrim	hrhr
hribit	rbb
hrikwz	rkz
hriswn	rsn
hriyw	rwy
hrkb	rkb
hrkh	rkk
hrpwah	rpa
hrqy	rqy
hrwem	rem
hrwqx	rqx
hrwx	rwx
hrxq	rxq
hrxwq	rxq
hrxwqim	rxq
hry	ryy
hryilim	ryl
hryiwn	ryi
hryiwni	ryi
hryiwnit	ryi
hryiwnwt	ryi
hsbibtit	sbb
hsbir	sbr
hsbrh	sbr
hsbrti	sbr
hsdr	sdr
hsdrim	sdr
hsgnwn	sgnn
hsibh	sbb
hsibwb	sbb
hsibwt	sbb
hsikwiim	ski
hsir	swr
hsiwrim	sir
hsiwy	siy
hskm	skm
hskmtm	skm
hsknh	skn
hskswk	sksk
hskswkim	sksk
hslmh	slm
hsmkwtiwt	smk
hsmlim	sml
hsmlit	sml
hsmwk	smk
hspiq	spq
hspqim	spq
hspr	spr
hspx	spx
hsqrim	sqr
hstbk	sbk
hsth	stt
hstiw	stw
hstm	stm
hswg	swg
hswhr	shr
hswprim	spr
hsyd	syd
htabdwtw	abd
htaimw	tam
htamc	amc
htamcw	amc
htamh	tam
htaxdwt	axd
htbiyh	tby
htbqew	bqe
htbrr	brr
htbrrh	brr
htbvlh	bvl
htbwnnti	bin
htbwnnw	bin
htetit	ett
htewbh	ewb
htgwbh	gwb
htiicbw	icb
htiixst	ixs
htiixswtw	ixs
htikwn	twk
htkwnwt	kwn
htkwwn	kwn
htlmidim	lmd
htlwnnh	lwn
htmikh	tmk
htmqdw	mqd
htmqdwtm	mqd
htnaim	tnh
htngdwt	ngd
htngewiwt	nge
htnhgwt	nhg
htnhl	nhl
htnkrwt	nkr
htnpc	npc
htnpcw	npc
htnwyh	nwy
htpevh	pev
htpevw	pev
htpilh	pll
htpll	pll
htpwgg	pwg
htpylh	pyl
htqbcw	qbc
htqbl	qbl
htqcib	qcb
htqerw	qer
htqewrt	qer
htqiimh	qwm
htqip	tqp
htqiph	tqp
htqrb	qrb
htqwph	nqp
htqwwh	qwi
htrbrbwt	rbrb
htrbwt	rbi
htremnw	rem
htrgewtm	rge
htrmh	trm
htrxb	rxb
htrymti	rym
htwamwt	tam
htwar	tar
htwcah	ica
htwdyh	idy
htwebim	ieb
htwknit	tkn
htwmkim	tmk
htwmkt	tmk
htwpyh	ipy
htwrh	iri
htwrn	trn
htxih	xii
htxil	txl
htxnh	xni
htxnnw	xnn
htxtit	txt
htxweh	xwe
htxzqw	xzq
htyeiitit	yei
htyniin	ynin
htyswqh	ysq
htywph	ywp
hvby	vby
hvbyi	vby
hvbyiim	vby
hvbyit	vby
hvbytw	vby
hvilw	nvl
hvip	nvp
hvirwp	vrp
hviwl	vil
hvmwn	vmn
hvph	nvp
hvrid	vrd
hvridh	vrd
hvwynim	vyn
hwbil	ibl
hwbs	bws
hwcah	ica
hwcatm	ica
hwcawt	ica
hwcbw	icb
hwdiy	idy
hwdiyh	idy
hwdpsh	dps
hwdth	idi
hwdwt	idi
hwdywt	idy
hwelk	elk
hwelkw	elk
hwgew	nge
hwkixh	ikx
hwkrxw	krx
hwkw	nki
hwlk	hlk
hwpiy	ipy
hwpk	hpk
hwpty	pty
hwqde	qde
hwqdew	qde
hwqrh	iqr
hwrawt	iri
hwrdh	ird
hwreh	rei
hwrh	iri
hwrim	hri
hwsipw	isp
hwtirw	itr
hwwydh	wyd
hwwyidwt	wyd
hwybr	ybr
hwybrw	ybr
hwylth	yli
hwymdw	ymd
hwzmnh	zmn
hxbrh	xbr
hxbrtit	xbr
hxbwiim	xba
hxdeim	xde
hxedwt	xed
hxeibh	xeb
hxewk	xek
hxi	xii
hxibwr	xbr
hxidwe	xde
hxiil	xil
hxiilim	xil
hxiim	xii
hxinwk	xnk
hxiwni	xwn
hxl	xll
hxlipwt	xlp
hxliv	xlv
hxlivh	xlv
hxllim	xll
hxlvi	xlv
hxlvwt	xlv
hxlw	xll
hxm	xmm
hxmiei	xme
hxmwr	xmr
hxnq	xnq
hxqirh	xqr
hxqirwt	xqr
hxqlaiim	xql
hxqlawt	xql
hxrdi	xrd
hxrdim	xrd
hxrigh	xrg
hxsd	xsd
hxsidim	xsd
hxsimh	xsm
hxsr	xsr
hxswt	xsi
hxtwm	xtm
hxwbh	xwb
hxwbrt	xbr
hxwc	xwc
hxwch	xwc
hxwle	xle
hxwleh	xle
hxwlim	xli
hxwmr	xmr
hxwpeit	xpe
hxwq	xwq
hxwzr	xzr
hybr	ybr
hybriin	ybr
hybrt	ybr
hybwdh	ybd
hycmawt	ycm
hycwbim	ycb
hycwt	iyc
hydpt	ydp
hydptm	ydp
hydwt	ywd
hyewiim	yei
hyimwt	ymt
hyiniim	yin
hyiqri	yqr
hyiqriim	yqr
hyiqrit	yqr
hyir	yir
hyiriih	yir
hyitwn	ytt
hylat	yli
hylh	yli
hylim	yli
hyliwn	yli
hyliwnh	yli
hyliwnim	yli
hylmin	ylm
hylw	yli
hylwl	yll
hylwlim	yll
hym	ymm
hymdtw	ymd
hymdwt	ymd
hymidh	ymd
hymwd	ymd
hyniin	yni
hyniq	ynq
hyniqh	ynq
hynq	ynq
hynqit	ynq
hyrbi	yrb
hyrbim	yrb
hyrbiwt	yrb
hyrh	ywr
hyrik	yrk
hyrikw	yrk
hyrt	ywr
hyrtw	ywr
hysq	ysq
hysqim	ysq
hysqt	ysq
hysqtm	ysq
hyt	ytt
hywbdh	ybd
hywbdim	ybd
hywbr	ybr
hywcr	ycr
hywiint	yin
hywlim	ylh
hywlm	ylm
hywmdt	ymd
hywmq	ymq
hywsqim	ysq
hyz	yzz
hzdhiti	zhi
hzdhwt	zhi
hzdmnwt	zmn
hzhb	zhb
hzhirh	zhr
hzihwi	zhi
hzikrwn	zkr
hzkir	zkr
hzkirh	zkr
hzkrti	zkr
hzkwt	zki
hzmn	zmn
hzmntm	zmn
hzqnim	zqn
hzrim	zwr
hzrmim	zrm
hzrmtw	zrm
hzwg	zwg
hzwkim	zki
hzwwywt	zwy
iair	awr
iamcw	amc
iarkw	ark
iarxw	arx
ibin	bin
ibis	bws
ibqew	bqe
ica	ica
icah	ica
icaw	ica
icbiy	cby
icib	icb
icibwt	icb
icirh	icr
iciyw	icy
icvrk	crk
icvrp	crp
icxq	cxq
idid	idd
idiywt	idy
idwn	dwn
idyti	idy
ieb	ieb
iebw	ieb
ieibh	ieb
ieibt	ieb
ieie	iee
ielmw	elm
ien	ien
ier	ier
iewbc	ebc
igdir	gdr
igiy	ngy
igiyw	ngy
ignh	gni
ihdwtw	ihd
ihih	hih
ihir	ihr
ihiw	hih
ihwdh	ihd
ihwdi	ihd
ihwdih	ihd
ihwdiih	ihd
ihwdim	ihd
ihwdiwt	ihd
iiasrw	asr
iibxr	bxr
iidw	idi
iiear	ear
iiewm	eim
iihpkw	hpk
iikllw	kll
iimca	mca
iimek	mek
iimekw	mek
iipgyw	pgy
iiqwm	nqm
iitkn	tkn
iitn	ntn
iiwwcr	icr
iiycrw	ycr
iizrq	zrq
ikbwe	kbe
ikinw	kwn
iklw	ikl
ikwl	ikl
ikwlh	ikl
ikwlim	ikl
ikwlwt	ikl
ildh	ild
ildi	ild
ildihm	ild
ildim	ild
ildinw	ild
ildw	ild
ilkw	hlk
imca	mca
imim	iwm
imin	imn
iminh	imn
imiw	iwm
imni	imn
imniim	imn
imnit	imn
imniwt	imn
insw	nsi
inyc	nyc
ipgmw	pgm
ipnw	pni
ipwvr	pvr
iqrh	qri
iqwm	nqm
irch	rci
irh	iri
irib	irb
iribim	irb
iribw	irb
iribwt	rib
iridh	ird
iriih	iri
iriwt	iri
irsqw	rsq
irw	iri
iskimw	skm
istkl	skl
iswd	isd
iswdwt	isd
itbcy	bcy
itkn	tkn
itmwddw	mdd
itqeh	qei
itr	itr
itrwn	itr
itrwnw	itr
itwmh	itm
itywrr	ywr
ivrxw	vrx
iwcat	ica
iwdy	idy
iwdyim	idy
iwebi	ieb
iwebim	ieb
iweg	neg
iwemh	iem
iwgdr	gdr
iwkl	ikl
iwm	iwm
iwpty	pty
iwrim	iri
iwtir	itr
iwtr	itr
iwvl	nvl
iwwtrw	wtr
iwylh	yli
ixd	ixd
ixdl	xdl
ixewb	xeb
ixid	ixd
ixidh	ixd
ixidim	ixd
ixpe	xpe
ixs	ixs
ixsim	ixs
ixsr	xsr
ixziq	xzq
iybwr	ybr
iyc	iyc
iyeh	yei
iyqb	yqb
iywrrw	ywr
izkwr	zkr
izmh	izm
kaie	aie
kaxd	axd
kbdim	kbd
kbeh	kbe
kbeim	kbe
kbib	bib
kbie	kbe
kbikwl	ikl
kbrit	bri
kbwl	kbl
kdin	dwn
kdriet	dre
kdrki	drk
kdwrbnwt	drbn
kdytm	idy
keain	ain
keaper	aper
kebiqrnw	bqr
kehkl	kll
kehmlxmh	lxm
kehqvip	qvp
kehxl	xll
keihpwk	hpk
kelie	ele
kelycmh	ycm
kemdwbr	dbr
kemxmmim	xmm
kenh	eni
keni	eni
kenicb	icb
kenwnim	enn
kepnihm	pni
keqrati	qra
keraiti	rai
kerc	rwc
kerwn	ker
kexebti	xeb
keyh	eyi
keywrpw	yrp
kgdwl	gdl
kgwn	gwn
khgdrtk	gdr
khn	khn
khw	khh
khwnh	khn
khwnt	khn
khwnwt	khn
kibwe	kbe
kielwn	kel
kielwnw	kel
kielwnwt	kel
kihnw	khn
kihwdi	ihd
kihwdim	ihd
kinh	kni
kipwt	kpp
kiwm	iwm
kiwwn	kwn
kkl	kll
kklwt	kli
kkwtrt	ktr
kl	kll
klbh	klb
kliatm	kla
klklh	klkl
klkli	klkl
klklth	klkl
kll	kll
kllim	kll
kllit	kll
klwlh	kll
klwmr	amr
kmbvah	bva
kmlxmh	lxm
kmnhl	nhl
kmnzr	nzr
kmrkz	rkz
kmtndbim	ndb
kmvrwt	nvr
kmvwrp	vrp
kmwbn	bin
kmwelt	mel
kmwsim	kms
kmxwwh	xwi
kmyv	myv
knrah	rai
knsiih	kns
knsiit	kns
knst	kns
kprh	kpr
kpwl	kpl
kqizwz	qzz
kqriah	qra
krae	rae
krgy	rgy
krk	krk
krki	krk
krkim	krk
krm	krm
krwz	krz
ksp	ksp
kspi	ksp
kspim	ksp
kspit	ksp
ktb	ktb
ktbh	ktb
ktbt	ktb
ktibtw	ktb
ktm	ktm
ktnwyh	nwy
ktwb	ktb
ktwcah	ica
ktwpyh	ipy
kwer	ker
kwll	kll
kwlnw	kll
kwlw	kll
kwrx	krx
kwtb	ktb
kwtbim	ktb
kwtbt	ktb
kwtli	ktl
kwtrt	ktr
kwx	kwx
kwxwt	kwx
kwys	kys
kxmieh	xme
kxwlh	kxl
kxwwiwt	xwi
kybwr	ybr
kym	ymm
kys	kys
kyt	ytt
kywbdt	ybd
kzkwr	zkr
ladm	adm
lahbh	ahb
lain	ain
lairwy	ary
lamnim	amn
lamt	amt
laneim	ane
lapliit	pli
larc	arc
larx	arx
lasiph	asp
lasipt	asp
laswp	asp
latr	atr
lawlmwt	alm
lawmi	lam
lawmiim	lam
lawmit	lam
lawmiwtm	lam
lawmni	lam
lawns	ans
lawpn	apn
lawrk	ark
laxd	axd
laxdim	axd
laxr	axr
laxwr	axr
lb	lbb
lbbi	lbb
lbcr	bcr
lbcy	bcy
lbd	bdd
lbdiqh	bdq
lbdk	bdd
lbdw	bdd
lbin	bin
lbit	bit
lbitw	bit
lbivwi	bva
lbkwt	bki
lbm	lbb
lbn	lbn
lbnw	lbb
lbrktw	brk
lbrr	brr
lbrwx	brx
lbswp	swp
lbti	bit
lbtihm	bit
lbvl	bvl
lbwa	bwa
lbwtnw	lbb
lbxirh	bxr
lbxwr	bxr
lbyih	byi
lbyli	byl
lcat	ica
lcd	cdd
lcibwr	cbr
lciin	cin
lcmcwm	cmcm
lcpwt	cph
lcrkiw	crk
lcvv	cvv
lcw	cwi
lcwrk	crk
lcwrki	crk
lcwwtwt	cwt
lcywd	cyd
ldawg	dag
ldbr	dbr
ldbri	dbr
ldbrihm	dbr
ldbrim	dbr
ldbriw	dbr
ldin	dwn
ldka	dka
ldrgim	drg
ldrgt	drg
ldrkw	drk
ldwbri	dbr
ldwgmwt	dgm
ldwwx	dwx
ldxwp	dxp
ldyh	idy
ldyt	idy
lealh	eal
lealti	eal
lealwt	eal
lear	ear
leat	nea
leawb	eab
lebirt	ebr
lebt	ewb
lebwywn	eby
lebyh	eby
legb	egb
legr	egr
leiaw	eia
leigywn	egy
leim	eim
leinwi	eni
leirwt	ert
leitwp	etp
lekny	kny
lekr	ekr
lelb	elb
lelivh	elv
lelm	elm
lelvwn	elv
lelvwnwt	elv
lelwe	ele
lelwm	elm
lelwv	elv
lelwx	elx
lemal	emal
lemalnim	emal
lemch	emc
lemwr	emr
lemwy	emy
lemxt	emx
leniim	eni
lentiim	eni
lenwa	ena
lepwv	epv
leqp	eqp
leri	err
lervv	ervv
letp	etp
letwq	etq
lewah	eai
lewb	ewb
lewlxn	elx
lewn	len
lewni	eni
lewnw	len
lewq	ewq
lexq	exq
lexrr	xrr
lgbe	gbe
lgbi	gbb
lgbwlwt	gbl
lgbwrwt	gbr
lget	nge
lgibwe	gbe
lgidwl	gdl
lgieh	nge
lgiis	gis
lgil	gil
lgirwem	gre
lglgniwt	lglg
lglim	gll
lglwt	gli
lgm	lgm
lgmri	gmr
lgre	gre
lgrwm	grm
lgrwr	grr
lgrwy	gry
lgwe	gwe
lgwpim	gwp
lgzrim	gzr
lhamin	amn
lhbdil	bdl
lhbhrtn	bhr
lhbia	bwa
lhbin	bin
lhbinn	bin
lhbis	bws
lhbiy	nby
lhbvix	bvx
lhcbiy	cby
lhchrt	chr
lhcig	icg
lhcigm	icg
lhcil	ncl
lhcilm	ncl
lhciy	icy
lhcmdh	cmd
lhcvmcm	cmcm
lhcyid	cyd
lhdgeh	dge
lhdgie	dge
lheair	ear
lheib	ewb
lheig	neg
lhelik	elk
lhelkwt	elk
lhepiy	epy
lhepyh	epy
lheqip	eqp
lheqph	eqp
lheqpwt	eqp
lhetlb	elb
lhetlv	elv
lhetqy	eqy
lhettpwt	etp
lhgdil	gdl
lhgeim	gem
lhgid	ngd
lhgie	nge
lhgiy	ngy
lhgn	gnn
lhgwt	hgi
lhiabq	abq
lhibnwt	bni
lhibxr	bxr
lhiear	ear
lhiemr	emr
lhiemy	emy
lhigmr	gmr
lhilxm	lxm
lhimny	mny
lhipge	pge
lhipk	hpk
lhipqx	pqx
lhipvr	pvr
lhiwm	iwm
lhiwt	hii
lhiwtw	hii
lhixeb	xeb
lhiyewt	yei
lhkeilm	kel
lhknis	kns
lhlk	hlk
lhlwwiitw	lwi
lhlwwt	lwi
lhmeik	mek
lhndsh	hnds
lhnix	nwx
lhpgnwt	pgn
lhpic	pwc
lhpikt	hpk
lhpiq	pwq
lhplt	npl
lhpriy	pry
lhpsiq	psq
lhpsqt	psq
lhptiy	pty
lhpwk	hpk
lhpyil	pyl
lhpyltm	pyl
lhqim	qwm
lhql	qll
lhrcah	rci
lhrewt	rei
lhrim	rwm
lhrviv	rvv
lhrwg	hrg
lhrxib	rxb
lhryil	ryl
lhsir	swr
lhskim	skm
lhspid	spd
lhspidw	spd
lhstir	str
lhstkn	skn
lhstmk	smk
lhstpx	spx
lhtbdx	bdx
lhtiixs	ixs
lhtiixswt	ixs
lhtir	ntr
lhtlbe	lbe
lhtlbv	lbv
lhtlqx	lqx
lhtmid	tmd
lhtmwdd	mdd
lhtngd	ngd
lhtnxlwt	nxl
lhtplsp	plsp
lhtprq	prq
lhtprywt	pry
lhtpwcc	pcc
lhtpzr	pzr
lhtqiim	qwm
lhtrem	rem
lhtrge	rge
lhtris	trs
lhtrkz	rkz
lhtrxq	rxq
lhtylm	ylm
lhtylwt	yli
lhtymt	ymt
lhvil	nvl
lhwcia	ica
lhwdiy	idy
lhwdwt	idi
lhweiy	iey
lhwgim	hgi
lhwlid	ild
lhwrg	hrg
lhwrid	ird
lhwrwt	iri
lhwwt	hwi
lhxdir	xdr
lhxziq	xzq
lhxzir	xzr
lhybir	ybr
lhyid	ywd
lhyiz	yzz
lhylat	yli
lhylwt	yli
lhyniq	ynq
lhyrkt	yrk
lhysiq	ysq
lhziq	nzq
lhzkir	zkr
lhzmnh	zmn
lhzyiq	zyq
licirt	icr
licwr	icr
lieibt	ieb
lihpk	hpk
lihwdim	ihd
liicg	icg
liicgh	icg
liieb	ieb
liiewm	iem
liisd	isd
likwltw	ikl
lilh	lil
limdt	lmd
limdwhw	lmd
limim	iwm
liqv	lqv
liwcaim	ica
liwm	iwm
liwwit	lwi
lixidim	ixd
lixs	ixs
lizkwr	zkr
lkbwd	kbd
lkbwe	kbe
lkiwwn	kwn
lklklt	klkl
lknsim	kns
lknst	kns
lkpwt	kpi
lkswt	ksi
lktwb	ktb
lkyin	yin
llimwd	lmd
llkt	hlk
llmwd	lmd
llxwc	lxc
llxwe	lxe
llywg	lyg
lmamr	amr
lmasr	asr
lmawrywt	ary
lmcbnw	icb
lmciawt	mca
lmcwa	mca
lmcwint	cin
lmcwt	mci
lmd	lmd
lmdiniwt	dwn
lmdinwt	dwn
lmdw	lmd
lmdy	idy
lmel	mel
lmemy	emy
lmerd	erd
lmert	eri
lmevrh	evr
lmewk	mek
lmhdrin	hdr
lmivtw	nvi
lmkwni	kwn
lmla	mla
lmlxmh	lxm
lmlxmt	lxm
lmlxmwt	lxm
lmme	mme
lmmelh	mel
lmnhlt	nhl
lmnwy	mny
lmnzr	nzr
lmpqdi	pqd
lmpry	pry
lmpyl	pyl
lmqrh	qri
lmqwm	qwm
lmqwrwt	qwr
lmrbh	rbb
lmrkz	rkz
lmrwt	mri
lmrwtw	mri
lmsqnh	nsq
lmsy	nsy
lmvr	mvr
lmvrwt	nvr
lmwel	mel
lmwelt	mel
lmwelwt	mel
lmwnyh	mny
lmwqdi	iqd
lmwwt	mwt
lmwymd	ymd
lmwymdim	ymd
lmxebwtikm	xeb
lmxiitm	xii
lmxlqt	xlq
lmxnh	xni
lmxnwt	xni
lmxqr	xqr
lmxrt	mxr
lmxwq	mxq
lmycr	ycr
lmycrm	ycr
lmyeh	yeh
lmylh	yli
lmyn	myn
lmynh	myn
lmyrich	yrc
lmysiqim	ysq
lmywd	myd
lmzimh	zmm
lmzrx	zrx
lnbxrt	bxr
lncl	ncl
lncx	ncx
lneiaim	nea
lneiawt	nea
lneim	ane
lngx	ngx
lnhl	nhl
lnicxwn	ncx
lnihwl	nhl
lnisiwn	nsi
lnisiwnw	nsi
lnisiwnwt	nsi
lniswx	nsx
lnkd	nkd
lnpgyim	pgy
lnqwdt	nqd
lnqwm	nqm
lnsiyh	nsy
lnswt	nsi
lnswy	nsy
lnvwy	nvy
lnwkx	nkx
lnwyr	nyr
lnyilt	nyl
lnzq	nzq
lpgiywt	pgy
lpgwy	pgy
lpiqwx	pqx
lpivwri	pvr
lpni	pni
lpniw	pni
lpnwt	pnh
lpqwd	pqd
lprv	prv
lpsqh	psq
lptwr	ptr
lpty	pty
lpwtrh	ptr
lpwyl	pyl
lpx	pxx
lpxwt	pxt
lpyilwiwt	pyl
lpyilwt	pyl
lpym	pym
lpymim	pym
lpywl	pyl
lqbc	qbc
lqblt	qbl
lqbwcwt	qbc
lqcr	qcr
lqhl	qhl
lqiim	qwm
lqiwm	qwm
lqrat	qra
lqratnw	qra
lqrn	qrn
lqrnwt	qrn
lqrqy	qrqy
lqrwbihm	qrb
lqry	qry
lqvip	qvp
lqwl	qwl
lqwm	qwm
lqwrbnwt	qrb
lqwxwt	lqx
lqx	lqx
lqxim	lqx
lrae	rae
lraewnh	rae
lrawt	rai
lrawtw	rai
lrb	rbb
lrbim	rbb
lrbwt	rbi
lrcwx	rcx
lrcx	rcx
lrdt	ird
lreimh	rem
lreimt	rem
lreimtw	rem
lrewt	rei
lrewtk	rei
lrge	rge
lrgewt	rge
lrgewtihm	rge
lrgl	rgl
lrkiet	rke
lrpa	rpa
lrsn	rsn
lrwc	rwc
lrwxb	rxb
lry	ryy
lsbk	sbk
lsbswd	sbsd
lsdr	sdr
lsgwr	sgr
lsiwm	sim
lsiwy	siy
lskn	skn
lsmlim	sml
lspriwt	spr
lswkk	skk
lswprim	spr
lswr	swr
lsxrwr	sxr
ltar	tar
ltgml	gml
ltgwbh	gwb
lthlik	hlk
ltiawr	tar
ltlmidim	lmd
ltlwnh	lwn
ltmihtw	tmh
ltmikh	tmk
ltnwyh	nwy
ltnwyt	nwy
ltqn	tqn
ltqwpt	nqp
ltrbwt	rbi
ltrbwtm	rbi
ltrwm	rwm
ltt	ntn
ltwar	tar
ltwby	tby
ltwebim	ieb
ltwknit	tkn
ltwkniwt	tkn
ltwpyh	ipy
ltwr	twr
ltxwm	txm
ltxwmiw	txm
ltyl	tyl
lvbx	vbx
lviwl	vil
lvwb	vwb
lvwbt	vwb
lvwbtm	vwb
lvywn	vyn
lwbei	lbe
lwbet	lbe
lwmr	amr
lwwdai	wdi
lwwiitw	lwi
lwwikwx	wkx
lwwtr	wtr
lwwyidwt	wyd
lwxiwt	lwx
lwxmi	lxm
lxbr	xbr
lxbrt	xbr
lxbrwt	xbr
lxc	lxc
lxci	xci
lxdd	xdd
lxeibh	xeb
lxewb	xeb
lxewe	xee
lxg	xgg
lxiewl	xel
lxiilim	xil
lxiim	xii
lxiiw	xii
lxipwe	xpe
lxiwt	xii
lxizwq	xzq
lxlli	xll
lxlq	xlq
lxlwnwt	xll
lxlwvin	xlv
lxm	lxm
lxpe	xpe
lxqlaim	xql
lxsl	xsl
lxvwp	xvp
lxwe	xwe
lxwg	xwg
lxwn	xnn
lxwq	xqq
lxwwih	xwi
lxwwiwt	xwi
lxzq	xzq
lxzwr	xzr
lxzwt	xzi
lybr	ybr
lybrw	ybr
lybwd	ybd
lybwdh	ybd
lycm	ycm
lycmm	ycm
lycmw	ycm
lyewt	yei
lyiin	yin
lyitim	ytt
lymwd	ymd
lyniin	ynin
lyniini	yni
lynwt	yni
lyqr	yqr
lyqrwn	yqr
lyqwb	yqb
lyqwr	yqr
lyrbim	yrb
lytim	ytt
lywbdh	ybd
lywbdim	ybd
lywbdwt	ybd
lywdd	ydd
lywlm	ylm
lywmt	ymt
lyzrt	yzr
lyzwr	yzr
lzhm	zhm
lzikrwn	zkr
lzkrw	zkr
lzkwiwt	zki
lzkwr	zkr
lzkwt	zki
lzrim	zwr
lzrm	zrm
lzrwywtiw	zry
mabn	abn
mabqim	abq
magr	agr
malp	alp
malpiim	alp
malwp	alp
mamc	amc
mamin	amn
maminim	amn
mamn	amn
mamr	amr
mamri	amr
mamrk	amr
mamrw	amr
maneim	ane
mapiin	apin
mapilim	apl
marcw	arc
margnt	argn
masmi	asm
masr	asr
mawd	mad
mawpiinim	apin
maws	mas
mawt	mai
mawxdwt	axd
mawxr	axr
maxr	axr
maxwr	axr
maxwri	axr
maxzihn	axz
mbcy	bcy
mbia	bwa
mbiaim	bwa
mbicwy	bcy
mbikh	bwk
mbikwt	bwk
mbin	bin
mbiqwrtw	bqr
mbit	bit
mbnh	bni
mbqe	bqe
mbqet	bqe
mbriqim	brq
mbv	nbv
mbva	bva
mbwa	bwa
mbwgr	bgr
mbwkh	bwk
mbwqeim	bqe
mbwsst	bss
mbxinh	bxn
mbxinth	bxn
mbxintw	bxn
mbyd	byd
mbyiit	byi
mbyiwt	byi
mbyli	byl
mbyr	byr
mcah	mca
mcb	icb
mcbiy	cby
mcbiyim	cby
mcbm	icb
mcd	cdd
mciah	mca
mciy	icy
mciywt	icy
mclix	clx
mcph	cpi
mcpim	cpi
mcviin	cin
mcviirt	cir
mcvrp	crp
mcvrpim	crp
mcwih	mca
mcwiim	mca
mcwwh	cwi
mcy	icy
mdbr	dbr
mdgieim	dge
mdin	dwn
mdinh	dwn
mdini	dwn
mdiniim	dwn
mdiniwt	dwn
mdint	dwn
mdintw	dwn
mdinwt	dwn
mdliq	dlq
mdmiy	dmy
mdrki	drk
mdrwm	drm
mdwbr	dbr
mdyi	idy
meair	ear
meait	nea
mebr	ebr
mebyh	eby
meeh	eee
meeim	eee
megewg	egeg
megiawt	egi
megix	egx
meimtm	ewm
meiniw	enn
meitwq	etq
mek	mek
mekilim	ekl
mekntawt	ekn
mekny	kny
mekr	ekr
melie	ele
melwet	ele
melxt	elx
meme	eme
memeim	eme
memiy	emy
memr	emr
memwnh	emn
memx	emx
memywt	emy
memywti	emy
menh	eni
mepv	epv
mepvi	epv
mepvim	epv
mepxh	epx
mepxt	epx
mepxth	epx
meqipim	eqp
merd	erd
merdit	erd
merh	eri
mertim	ert
mertwt	ert
merwt	eri
metdlim	edl
meti	eni
mevr	evr
mevrh	evr
mevrim	evr
mevrt	evr
mewbct	ebc
mewknyim	ekny
mewll	ell
mewmyiw	emy
mewsy	esy
mewtpim	etp
mewtpt	etp
mexqi	exq
meyew	yei
meywt	eyi
mgbyt	gby
mgdir	gdr
mgdl	gdl
mgib	gwb
mgiis	gis
mgilt	gll
mgiy	ngy
mgiyim	ngy
mgn	gwn
mgnnh	gnn
mgwnh	gni
mgwrihm	gwr
mgwwn	gwn
mgzynwt	gzy
mhcd	cdd
mhcibwr	cbr
mheqpwt	eqp
mheqpwtiw	eqp
mhevxim	evx
mhewah	eai
mhhikrwt	nkr
mhhtprcwt	prc
mhimin	imn
mhimnim	imn
mhksp	ksp
mhktb	ktb
mhlikwd	lkd
mhlk	hlk
mhlwwih	lwi
mhmamr	amr
mhmcb	icb
mhmqwm	qwm
mhmr	hmr
mhmrkz	rkz
mhmtpryim	pry
mhmynq	ynq
mhnmwkwt	nmk
mhnsiyh	nsy
mhpqt	pwq
mhqhl	qhl
mhqrb	qrb
mhr	mhr
mhrkb	rkb
mhryiwn	ryi
mhsgnwn	sgnn
mhswg	swg
mhtnhgwt	nhg
mhtnwyh	nwy
mhtqwph	nqp
mhtwpyh	ipy
mhwwh	hwi
mhxbrim	xbr
mhxiim	xii
mhyiirh	yir
mhyir	yir
mhyrbim	yrb
mhywbdh	ybd
mhywlm	ylm
mhzdhwt	zhi
mi	mim
mibxn	bxn
micmc	mcmc
midh	mdd
midy	idy
miicat	ica
miicg	icg
miisr	isr
miixs	ixs
mikl	kwl
milaw	mla
milwa	mla
milwi	mla
milwliwt	mll
mim	mim
mimn	mmn
mimwn	mmn
min	min
minhli	nhl
mirb	rbb
miri	iri
mirwcim	rwc
miwmnwt	imn
miwmnwtw	imn
miwn	min
miwtmim	itm
miwtr	itr
miwtrt	itr
miwxd	ixd
miwxdim	ixd
miwyd	iyd
miywvim	myv
mkbr	kbr
mkhn	khn
mkinim	kwn
mkir	nkr
mkirim	nkr
mkirt	mkr
mkisw	kis
mkiwwn	kwn
mkl	kll
mknh	kni
mkrix	krx
mkspi	ksp
mktb	ktb
mktbh	ktb
mkwbdt	kbd
mkwn	kwn
mkwnitw	kwn
mkwniwt	kwn
mla	mla
mlah	mla
mlaiim	aim
mlak	lak
mlakwtit	lak
mlaw	mla
mlh	mll
mlhcig	icg
mlhdgie	dge
mlhgbil	gbl
mlhib	lhb
mliixs	ixs
mlim	mll
mlk	mlk
mlktxilh	xll
mlnswt	nsi
mlwa	mla
mlwnai	lwn
mlwt	mll
mlx	mlx
mlxmh	lxm
mlxmt	lxm
mmah	mai
mmamrk	amr
mmawt	mai
mmcai	mca
mmcia	mca
mmdint	dwn
mmdiw	mdd
mmdrgh	drg
mme	mme
mmei	mme
mmeikh	mek
mmelt	mel
mmerd	erd
mmettpi	etp
mmginim	gnn
mmirwci	rwc
mmkwnit	kwn
mmkwt	nki
mmla	mla
mmplgt	plg
mmpqdi	pqd
mmqrh	qri
mmqwm	qwm
mms	mss
mmtqim	mtq
mmwnh	mni
mmxdlim	xdl
mmxqrw	xqr
mmycbi	ycb
mmymd	ymd
mnbki	nbk
mnclim	ncl
mnhig	nhg
mnhl	nhl
mnhli	nhl
mnhlim	nhl
mnhlt	nhl
mnix	nwx
mniyim	nwy
mnqrwt	nqr
mnqwdh	nqd
mnsh	nsi
mnsim	nsi
mnth	mni
mnvl	nvl
mnwmqt	nmq
mnwsx	nsx
mnwwnt	nwn
mnxe	nxe
mny	mny
mnyh	mny
mnzr	nzr
mpginim	pgn
mpgiyt	pgy
mplgh	plg
mplgth	plg
mplgtw	plg
mpqd	pqd
mpqdt	pqd
mpridim	prd
mprsm	prsm
mpth	pti
mptiy	pty
mptiywt	pty
mptx	ptx
mpwrsmim	prsm
mpyl	pyl
mpylim	pyl
mpym	pym
mqbl	qbl
mqbli	qbl
mqc	qcc
mqcth	qcc
mqdet	qde
mqdmi	qdm
mqimi	qwm
mqip	nqp
mqly	qly
mqnnt	qnn
mqpiat	qpa
mqrb	qrb
mqrh	qri
mqrin	qrn
mqrn	qrn
mqrnwt	qrn
mqrwb	qrb
mqwbl	qbl
mqwblim	qbl
mqwm	qwm
mqwmh	qwm
mqwmi	qwm
mqwmiim	qwm
mqwmit	qwm
mqwmw	qwm
mqwmwt	qwm
mqwr	qwr
mqwrbnwtiw	qrb
mqwrwt	qwr
mraei	rae
mrah	rai
mrbh	rbi
mrcx	rcx
mrd	mrd
mrdp	rdp
mreim	rem
mreimim	rem
mreimwt	rem
mrge	rge
mrgeim	rge
mrgie	rge
mrglim	rgl
mrh	mrr
mrim	mrr
mrkibiw	rkb
mrkz	rkz
mrkzi	rkz
mrkziim	rkz
mrkzit	rkz
mrmzt	rmz
mrpst	rps
mrqxt	rqx
mrvw	mrv
mrwb	rbb
mrwbi	rbi
mrwby	rby
mrx	mrx
mrxb	rxb
msbb	sbb
msbib	sbb
msgidh	sgd
msgrt	sgr
msikwi	ski
msim	mss
msipwriw	spr
msiq	nsq
msivim	swv
mskim	skm
mskn	skn
mslwl	sll
msmk	smk
msmlim	sml
mspiq	spq
mspr	spr
mspriw	spr
msprm	spr
msprn	spr
msqnwt	nsq
msr	msr
msrh	msr
msrw	msr
mstbr	sbr
mstiig	sig
msttrim	str
mswg	swg
mswgl	sgl
mswglim	sgl
mswglt	sgl
mswim	sim
mswimim	sim
mswimt	sim
mswkn	skn
mswknt	skn
mswpq	spq
mswrt	msr
msy	nsy
msyipiw	syp
mtamct	amc
mtarim	tar
mtaxdim	axd
mtbrr	brr
mtbwnn	bin
mtcpit	cpi
mtgiisim	gis
mtgwrr	gwr
mth	mwt
mtiixdim	ixd
mtir	ntr
mtkwwn	kwn
mtlbv	lbv
mtlmidi	lmd
mtlwnnim	lwn
mtn	ntn
mtndbim	ndb
mtnea	nea
mtngdi	ngd
mtnhlwt	nhl
mtper	per
mtplc	plc
mtqbl	qbl
mtqrb	qrb
mtrgzim	rgz
mtrwcc	rwc
mtrwmwtihn	trm
mtrymim	rym
mtt	ntn
mtwcawt	ica
mtwk	twk
mtwknnim	tkn
mtwxkm	xkm
mtxil	txl
mtxilh	xll
mtxilwt	txl
mtxrim	xri
mtxt	txt
mtycmt	ycm
mtylm	ylm
mtyniinim	ynin
mtywppim	ywp
mvh	nvi
mvhw	nvi
mvlpn	vlpn
mvrd	vrd
mvweve	veve
mvwrp	vrp
mvwrpwt	vrp
mvym	vym
mwbhq	bhq
mwblt	ibl
mwbn	bin
mwbvx	bvx
mwcnyim	cny
mwdy	idy
mwdyt	idy
mwebw	ieb
mwel	mel
mweli	mel
mwelwt	mel
mwepy	epy
mweqy	eqy
mwgbl	gbl
mwgblt	gbl
mwgzm	gzm
mwke	nke
mwker	ker
mwkix	ikx
mwkn	kwn
mwknh	kwn
mwkr	nkr
mwldt	ild
mwlikim	ilk
mwmlc	mlc
mwmn	mmn
mwmxim	mxi
mwnim	amn
mwnxim	nwx
mwny	mny
mwpnh	pni
mwpnim	pni
mwprd	prd
mwqdm	qdm
mwqywt	iqy
mwrdi	mrd
mwret	ire
mwrh	iri
mwrkbwt	rkb
mwsbt	sbb
mwsd	isd
mwsdwt	isd
mwsgr	sgr
mwsip	isp
mwsmk	smk
mwspw	isp
mwsri	isr
mwsrit	isr
mwtir	itr
mwtnit	tni
mwtqpim	tqp
mwtr	ntr
mwtw	mwt
mwvb	vwb
mwvl	nvl
mwvlt	nvl
mwvxt	vix
mwwt	mwt
mwwydi	wyd
mwx	mxx
mwxc	ixc
mwxeiim	xwe
mwxlv	xlv
mwxzqim	xzq
mwxzr	xzr
mwybr	ybr
mwyd	iyd
mwymd	ymd
mwymdwt	ymd
mwzmnim	zmn
mwzrh	zwr
mxbr	xbr
mxci	xci
mxcit	xci
mxde	xde
mxdlihm	xdl
mxebh	xeb
mxebwt	xeb
mxee	xee
mxeipt	xep
mxiibt	xib
mxlh	xli
mxlqwt	xlq
mxnh	xni
mxnkim	xnk
mxnwt	xni
mxpe	xpe
mxpeim	xpe
mxpet	xpe
mxpir	xpr
mxqr	xqr
mxqrim	xqr
mxr	mxr
mxrid	xrd
mxrip	xrp
mxsidi	xsd
mxswmim	xsm
mxswt	xsi
mxtrt	xtr
mxwc	xwc
mxwdd	xdd
mxwdet	xde
mxwgi	xwg
mxwwh	xwi
mxwz	xwz
mxziqh	xzq
mxzwriwt	xzr
mybir	ybr
mycbwt	ycb
mycmm	ycm
myd	myd
mydi	ywd
mydip	ydp
myeh	yei
myei	yei
myeihm	yeh
myeim	yei
myeiwt	yei
myidh	ywd
myidwt	myd
myiinwt	yin
myin	yin
myizim	yzz
myl	yli
mylh	yli
mylwt	yli
mymd	ymd
mymdit	ymd
mymdw	ymd
mymidh	ymd
myniinim	ynin
mynq	ynq
mynqim	ynq
myqb	yqb
myrbii	yrb
myrik	yrk
myrk	yrk
myrkt	yrk
myrkwnim	yrk
myrkwt	yrk
mysiqi	ysq
mysiqw	ysq
myv	myv
myvim	myv
mywbdiw	ybd
mywlm	ylm
mywniin	ynin
mywrbim	yrb
mywrbt	yrb
mywrr	ywr
mywrrim	ywr
mywrrwt	ywr
mzgw	mzg
mzhibim	zhb
mzimh	zmm
mzkir	zkr
mzkirwt	zkr
mzmn	zmn
mzriqt	zrq
mzwwdwtiw	zwd
nabqim	abq
naclwt	acl
nah	nai
nalcim	alc
namn	amn
namnwiwtiw	amn
namnwt	amn
namr	amr
namrim	amr
nawm	nam
nbkh	bki
nbra	bra
nbwb	nbb
nbxnim	bxn
nbxr	bxr
nbxrh	bxr
nbxrim	bxr
nbxrt	bxr
nbxrw	bxr
nbyh	nby
nbytw	byt
ncig	icg
nciwt	ncc
ncph	cpi
ncvww	cwi
ndmh	dmi
ndqr	dqr
ndre	dre
ndxqw	dxq
nea	nea
near	ear
nearh	ear
nearw	ear
neaw	nea
nebr	ebr
nebrh	ebr
neia	nea
neiaim	nea
neiawt	nea
neiawtiim	nea
neiawtw	nea
neim	aee
nelx	elx
nemh	nem
nemrh	emr
nemyw	emy
nep	nep
nepk	epk
nepvw	epv
nepwk	epk
neq	neq
nerph	erp
newi	nea
ngd	ngd
ngdh	ngd
ngdw	ngd
ngh	ngh
ngiyh	ngy
ngrm	grm
ngsw	ngs
ngyw	ngy
nhg	nhg
nhgt	nhg
nhirt	nhr
nhnh	hni
nhnim	hni
nhnw	hni
nhrg	hrg
nhrgw	hrg
nicb	icb
nicwlt	ncl
nicwr	icr
nicx	ncx
nicxt	ncx
nicxwn	ncx
nicxwnh	ncx
nicxwnwt	ncx
nidwn	dwn
nidwnw	dwn
nignh	ngn
nihl	nhl
niir	nir
niirwt	nir
nikr	nkr
nikrim	nkr
nikrt	nkr
nimi	nim
ninwxh	nwx
nipcw	npc
niqwm	nqm
nish	nsi
nisiti	nsi
nisiwn	nsi
nisiwnw	nsi
nisw	nsi
nitn	ntn
nitnh	ntn
nitnim	ntn
nitnt	ntn
nkbd	kbd
nkel	kel
nkllw	kll
nknst	kns
nktb	ktb
nkwn	kwn
nkwnim	kwn
nkxw	nkx
nlhb	lhb
nlhbt	lhb
nlk	hlk
nlmd	lmd
nlxmim	lxm
nlyg	lyg
nmash	mas
nmca	mca
nmcaim	mca
nmcawt	mca
nmek	mek
nmekw	mek
nmir	mwr
nmlv	mlv
nmlvt	mlv
nmnh	mni
nmnth	mni
nmnyw	mny
nmrct	mrc
nmsr	msr
nmwkh	nmk
npcy	pcy
npcyh	pcy
npcyw	pcy
npgeim	pge
npgy	pgy
npgyi	pgy
npgyim	pgy
nplh	npl
nplvh	plv
nprd	prd
npt	npi
npwch	pwc
npxw	npx
nqby	qby
nqi	nqi
nqivt	nqv
nqly	qly
nqlyh	qly
nqlynw	qly
nqm	nqm
nqmh	nqm
nqmtw	nqm
nqmwt	nqm
nqwdwt	nqd
nr	nwr
nrah	rai
nraim	rai
nraw	rai
nrcx	rcx
nremim	rem
nrgm	rgm
nrxb	rxb
nrxbwt	rxb
nsbl	sbl
nsgr	sgr
nsgrw	sgr
nsibwt	sbb
nskh	nsk
nspw	spi
nstgr	sgr
nsxp	sxp
ntib	ntb
ntpst	tps
ntql	tql
ntrah	rai
ntwn	ntn
ntxdeh	xde
ntxim	ntx
nviitw	nvi
nvl	nvl
nwcr	icr
nwcx	ncx
nwcxh	ncx
nwdy	idy
nwea	nea
nweaim	nea
nweat	nea
nwhg	nhg
nwhrim	nhr
nwkl	ikl
nwkxwtn	nkx
nwld	ild
nwpcw	npc
nwplim	npl
nwplt	npl
nwplwt	npl
nwqbt	nqb
nwqeh	qei
nwqvt	nqv
nwrw	iri
nwsp	isp
nwspim	isp
nwspt	isp
nwspwt	isp
nwsx	nsx
nwsxawt	nsx
nwsxh	nsx
nwsy	nsy
nwsyim	nsy
nwtn	ntn
nwtnt	ntn
nwtr	itr
nwtrw	itr
nwxwt	nwx
nwydw	iyd
nwyr	nyr
nxe	nxe
nxepw	xep
nxlqt	xlq
nxlqwt	xlq
nxmd	xmd
nxwc	nxc
nyeth	yei
nylm	ylm
nylmw	ylm
nylw	nyl
nymwd	ymd
nynw	yni
nyri	nyr
nyrk	yrk
nzhr	zhr
nzirwt	nzr
nzkh	zki
nzkr	zkr
nzkwr	zkr
nzq	nzq
nzqqim	zqq
nzrq	zrq
nzrqh	zrq
pcwy	pcy
pcwyim	pcy
pcyw	pcy
per	per
perh	per
pewv	pev
pewvh	pev
pg	pwg
pgiyh	pgy
pgwm	pgm
pgyh	pgy
pgyw	pgy
pigwy	pgy
piqpq	pqpq
piqwd	pqd
pirsm	prsm
pla	pla
plgi	plg
plietm	ple
plivim	plv
plivt	plv
pnh	pni
pni	pni
pnim	pni
pnimh	pnm
pqid	pqd
pqidi	pqd
pqwdwt	pqd
prc	prc
prch	prc
prcw	prc
prei	pre
preiwt	pre
pret	pre
prich	prc
priv	prv
prq	prq
prsh	prs
prsm	prsm
prswm	prsm
prvi	prv
prvim	prv
prwy	pry
prxim	prx
pslw	psl
psqh	psq
pswlh	psl
pswqi	psq
ptixwt	ptx
ptrwn	ptr
ptrwnw	ptr
ptrwnwt	ptr
ptrwnwtihm	ptr
ptwxh	ptx
ptx	ptx
ptxw	ptx
pvwr	pvr
pwgyim	pgy
pwlxn	plx
pwnh	pni
pwrqn	prq
pwrsm	prsm
pwrsmh	prsm
pwsq	psq
pwtxim	ptx
pwxdim	pxd
pwyl	pyl
pwylihm	pyl
px	pxx
pxd	pxd
pxt	pxt
pxwt	pxt
pyil	pyl
pyilim	pyl
pyilwt	pyl
pylw	pyl
pym	pym
pymiim	pym
pymim	pym
pywlh	pyl
pywlwt	pyl
qbiyt	qby
qblt	qbl
qbr	qbr
qbrw	qbr
qbrwtihm	qbr
qbwch	qbc
qbwct	qbc
qbwcwt	qbc
qbwrtw	qbr
qbwywt	qby
qby	qby
qbyh	qby
qch	qci
qcin	qcn
qciniw	qcn
qcr	qcr
qct	qci
qdie	qde
qdiea	qde
qdimh	qdm
qdimwiwt	qdm
qdm	qdm
qdwm	qdm
qeh	qei
qer	qer
qewr	qer
qewrim	qer
qewt	qei
qhilh	qhl
qhilti	qhl
qhiltiim	qhl
qhiltit	qhl
qhl	qhl
qibl	qbl
qicwcim	qcc
qicwni	qcn
qicwniwt	qcn
qierw	qer
qiim	qwm
qiimt	qwm
qillw	qll
qiq	dqq
qiwm	qwm
qiwmh	qwm
ql	qll
qlilwt	qll
qllwt	qll
qmh	qwm
qmim	qwm
qnaim	qna
qnswt	qns
qpdnit	qpd
qpich	qpc
qra	qra
qrati	qra
qraw	qra
qrb	qrb
qrbi	qrb
qrbn	qrb
qrbwt	qrb
qre	qre
qrh	qri
qriat	qra
qriawt	qra
qristn	qrs
qrn	qrn
qrnwt	qrn
qrth	qri
qrwb	qrb
qrwbwt	qrb
qry	qry
qvip	qvp
qvn	qvn
qvnim	qvn
qvyi	qvy
qwby	qby
qwdm	qdm
qwl	qwl
qwlw	qwl
qwlwt	qwl
qwra	qra
qwraim	qra
qwrbn	qrb
qwrh	qri
qxw	lqx
rae	rae
raei	rae
raeihm	rae
raeit	rae
raewn	rae
raewnh	rae
raewni	rae
rah	rai
rainw	rai
raiti	rai
raw	rai
rawi	rai
rawih	rai
rawwh	rai
rb	rbb
rbbwt	rbb
rbh	rbb
rbi	rbb
rbim	rbb
rbrbnim	rbrb
rbw	rbb
rbwt	rbb
rbwti	rbb
rc	rwc
rch	rci
rcim	rwc
rcini	rcn
rcinit	rcn
rciniwt	rci
rcixwt	rcx
rcnw	rwc
rcth	rci
rcwn	rci
rcwp	rcp
rcx	rcx
rcxw	rcx
rdipt	rdp
reait	rei
reimt	rem
reimtw	rem
reimwt	rem
reiwn	reh
reiwnwt	rei
rem	rem
remi	rem
remit	rem
remiw	rem
remt	rem
rewt	rei
rge	rge
rgeiim	rge
rgewt	rge
rgewtihm	rge
rgewtiw	rge
rgl	rgl
rhb	rhb
ribit	rbb
rik	crk
rikz	rkz
riq	riq
riqh	riq
risn	rsn
rkb	rkb
rkwb	rkb
rkwem	rke
rmim	rwm
rmt	rwm
rmz	rmz
rn	rnn
rqmw	rqm
rqy	rqy
rwah	rai
rwaim	rai
rwb	rbb
rwbcim	rbc
rwbm	rbb
rwbn	rbb
rwch	rch
rwcim	rci
rwcxw	rcx
rwdni	rdi
rwem	rem
rwemim	rem
rwpa	rpa
rwtx	rtx
rwwx	rwx
rwwxim	rwx
rwx	rwx
rxb	rxb
rxbi	rxb
rxbt	rxb
rxmim	rxm
rxwq	rxq
rxwqim	rxq
ry	ryy
ryhw	ryi
ryih	ryi
ryiwnwt	ryi
rywli	ryl
sbib	sbb
sbibh	sbb
sbibwtiw	sbb
sbir	sbr
sbirh	sbr
sbl	sbl
sblni	sbl
sbrw	sbr
sbswd	sbsd
sbwr	sbr
sbwrim	sbr
sdr	sdr
sgidh	sgd
sgrw	sgr
sgwr	sgr
shrwrit	shr
sibh	sbb
siimh	sim
siiy	siy
sikn	skn
sikwi	ski
silqw	slq
simnim	smn
simwkin	smk
sinnti	snn
sipq	spq
sipr	spr
siprti	spr
siprw	spr
sipwrh	spr
sipwri	spr
sipwx	spx
sirb	srb
sirbh	srb
sirbw	srb
siwr	sir
siwrim	sir
siwy	siy
skr	skr
skswk	sksk
smk	smk
sml	sml
smli	sml
smlim	sml
smlit	sml
smliw	sml
smwk	smk
spq	spq
spr	spr
spwr	spr
sqirwt	sqr
sqr	sqr
sqri	sqr
sqrim	sqr
sqrnwt	sqr
srq	srq
srvi	srv
srwgwt	srg
stm	stm
swblim	sbl
swblnwt	sbl
swdiwth	swd
swdwt	swd
swg	swg
swgr	sgr
swp	swp
swpr	spr
syd	syd
syip	syp
syw	nsy
tawch	awc
tbia	bwa
tbvix	bvx
tbwdd	bdd
tbwsh	bws
tbyrh	byr
tca	ica
tcbiy	cby
tcbiyw	cby
tcib	icb
tclwm	clm
tdyk	dyk
tedir	edr
tediri	edr
telm	elm
telwmim	elm
temy	emy
tetit	ett
tewbh	ewb
tewmt	eim
tgbe	gbe
tgi	twg
tgiy	ngy
tgmwlim	gml
tgrwm	grm
tgwbh	gwb
thih	hii
thilim	hll
thlik	hlk
thpwkwt	hpk
thw	thi
tiamn	amn
tiar	tar
tiawm	tam
tiawr	tar
tiawri	tar
tigyw	ngy
tiirim	twr
tiirt	twr
tikp	tkp
timek	mek
tinwqth	inq
tiqim	tiq
tixsk	xsk
tiyeh	yeh
tklit	kli
tknitw	tkn
tkwnwtihm	kwn
tkwnwtiw	kwn
tl	tll
tlawt	lai
tlk	hlk
tlmid	lmd
tlmidi	lmd
tlmidim	lmd
tlwi	tli
tlwlh	tll
tlwnwt	lwn
tlwt	tli
tm	tmm
tmcit	mci
tmeik	mek
tmh	tmh
tmhwni	tmh
tmid	tmd
tmihh	tmh
tmikh	tmk
tmim	tmm
tmk	tmk
tmwhh	tmh
tmwrt	mwr
tnwph	nwp
tnwyh	nwy
tnwyt	nwy
tnwywtihm	nwy
tpew	tpe
tpish	tps
tpnh	pnh
tpqid	pqd
tpqidi	pqd
tpqidim	pqd
tpqidm	pqd
tpqidw	pqd
tpxd	pxd
tpxdw	pxd
tqbl	qbl
tqcib	qcb
tqdim	qdm
tqewrt	qer
tqn	tqn
tqpid	qpd
tqpw	tqp
tqrit	qri
tqwh	qwi
tqwph	nqp
tqwpt	nqp
tqwwh	qwi
tqwyh	tqy
tqyh	tqy
trbwt	rbi
trbwti	rbi
trbwtiwt	rbi
trmh	trm
trwmwt	trm
trwpwt	rpa
tsbik	sbk
tsbsd	sbsd
tsbwl	skl
ttamt	amt
ttaper	aper
ttgem	gem
ttkwpp	kpp
ttmwdd	mdd
tvrxw	vrx
twart	tar
twarw	tar
twby	tby
twbyim	tby
twcawt	ica
twcawtih	ica
tweb	ieb
twebi	ieb
twebih	ieb
twebim	ieb
twemy	emy
twk	twk
twkix	ikx
twkl	ikl
twkn	tkn
twknit	tkn
twkniwt	tkn
twknnw	tkn
twm	twm
twmk	tmk
twmki	tmk
twmkim	tmk
twmkiw	tmk
twmkt	tmk
twps	tps
twpyh	wpy
twpyt	ipy
twpywt	ipy
twqpnwth	tqp
twqy	tqy
twsip	isp
twyltniim	iyl
twysq	ysq
txdl	xdl
txilh	xll
txliv	xlv
txnt	xni
txqir	xqr
txrwt	xri
txt	txt
txweh	xwe
txzit	xzi
txzitw	xzi
tyeh	yeh
tyeiit	yei
tyeiitiwt	yei
tyid	ywd
tymwlth	yml
tzkh	zki
tzkir	zkr
vbyh	vby
vbyi	vby
vbyiwt	vby
vihwr	vhr
vipwl	vpl
viwl	vil
viywn	vyn
viywnim	vyn
vmnh	vmn
vpilim	vpl
vrm	vrm
vrxh	vrx
vrxw	vrx
vwb	vwb
vwbh	vwb
vwbim	vwb
vwbt	vwb
vwhr	vhr
vwplh	vpl
vwplw	vpl
vwpsi	vps
vwr	vwr
vwyim	vyi
vwynim	vyn
vyn	vyn
vynh	vyn
vynw	vyn
vynwt	vyn
vywt	vyi
wadmth	adm
wahbh	ahb
waibri	abr
waie	aie
wain	ain
wainm	ain
wainnh	ain
wainw	ain
wal	ali
wamrw	amr
wanei	ane
waneim	ane
warby	rby
warbyh	rby
waswr	asr
wawepzh	aepz
wawmr	amr
wawsip	isp
waxr	axr
waxrim	axr
wb	ewb
wbadm	adm
wbarcwt	arc
wbaw	bwa
wbaxrit	axr
wbcwmt	cmt
wbdrk	drk
wbear	ear
wbemal	emal
wber	ber
wbewvrim	evr
wbgdwl	gdl
wbhtnqewiwt	nqe
wbieibh	ieb
wbin	bin
wbiqe	bqe
wbiqr	bqr
wbkl	kll
wblbd	bdd
wbmcb	icb
wbmdint	dwn
wbmdinwt	dwn
wbmqwm	qwm
wbmqwmwt	qwm
wbmwdge	dge
wbmwvwt	mwv
wbmwwt	mwt
wbqrh	bqr
wbreimtw	rem
wbretwt	ret
wbrgei	rge
wbrgliim	rgl
wbrix	brx
wbrwr	brr
wbsilwp	slp
wbsriqwt	srq
wbthlik	hlk
wbtxwm	txm
wbvwb	vwb
wbwwdai	wda
wbxwpe	xpe
wbycm	ycm
wbyiqr	yqr
wbyir	yir
wbyitwnai	ytt
wbyli	byl
wbyqbwt	yqb
wbywlm	ylm
wciri	cir
wcpwph	cpp
wcr	crr
wcwbrt	cbr
wcwwtwt	cwt
wcxq	cxq
wcyqwt	cyq
wdawt	wda
wdmwiwt	dmi
wdq	dqq
wdrwm	drm
wdwmh	dmi
wdwmiw	dmi
wdwqrni	dqr
wdwykwt	dyk
wdyikt	dyk
webwy	eby
wehmxebwt	xeb
weimeh	eme
welewl	elel
welewm	ele
welvwnwt	elv
welweh	ele
wemy	emy
wenihm	eni
wepiwt	epi
weqy	eqy
weti	eni
wetiqh	etq
wetrxiq	rxq
wewal	eal
wewb	ewb
wewxrrw	exrr
weyrbim	yrb
wgawlh	gal
wgbwlwt	gbl
wgidwpim	gdp
wgwbrt	gbr
wgwptw	gwp
whaneim	ane
whaxr	axr
whaxrim	axr
whcba	cba
whcicw	cic
whciy	icy
whclixw	clx
whcyr	cyr
whdgeti	dge
whdglim	dgl
whelivw	elv
wheni	eni
whewah	eai
whgbwrh	gbr
whgdil	gdl
whgiew	nge
whgirweim	gre
whhcmdh	cmd
whildim	ild
whiribwt	rib
whkl	kll
whlikwtiw	hlk
whlilh	lil
whlimwdim	lmd
whlk	hlk
whlyg	lyg
whmabq	abq
whmmelh	mel
whmnwkr	nkr
whmpwarim	par
whmsr	msr
whmswknt	skn
whmtper	per
whmwkrwt	nkr
whmwwt	mwt
whmywwtt	ywt
whniirwt	nir
whnixw	nwx
whpqy	pqy
whqhl	qhl
whqrbh	qrb
whrbh	rbi
whrgeti	rge
whrwwxh	rwx
whsdr	sdr
whtewbh	ewb
whtnhgwt	nhg
whtnxlw	nxl
whtqewrt	qer
whtxtnh	xtn
whvil	nvl
whvlt	nvl
whwbilh	ibl
whwlk	hlk
whwlkim	hlk
whwlkwt	hlk
whwrdt	ird
whwrh	iri
whwybr	ybr
whxidwe	xde
whxmimwt	xmm
whybwdh	ybd
whyir	yir
whysq	ysq
whzdhwt	zhi
whzwwyh	zwy
wigbrw	gbr
wigid	ngd
wigwrew	gre
wihwdim	ihd
wiitkn	tkn
wikwx	wkx
wildiw	ild
wiprcw	prc
wiqrh	iqr
wiribw	rib
wirq	irq
wismnw	smn
witrh	itr
witwr	wtr
wiwdy	idy
wiwtr	itr
wiwxrp	xrp
wiyidw	ywd
wizkirw	zkr
wkdwmh	dmi
wkiwm	iwm
wkkhn	khn
wkl	kll
wklbihm	klb
wklklnim	klkl
wkmyv	myv
wktwcah	ica
wkwkb	kkb
wkwlm	kll
wkyt	ytt
wkzb	kzb
wlakwl	akl
wlargwnim	argn
wlarigh	arg
wlaxr	axr
wlbm	lbb
wlbva	bva
wlekny	kny
wleyr	eyr
wlhbiy	nby
wlhgn	gnn
wlhibxr	bxr
wlhilxm	lxm
wlhknst	kns
wlhmtin	mtn
wlhqdie	qde
wlhsiq	nsq
wlhtrge	rge
wlhtwwydwiwt	wyd
wlhvbiy	vby
wlihnwt	hni
wlkl	kll
wlmkrihm	nkr
wlmrwt	mri
wlmtn	ntn
wlmweli	mel
wlmyeh	yei
wlmyeikm	yei
wlmzkir	zkr
wlnqwm	nqm
wlnwwv	nwv
wlpgwy	pgy
wlpni	pni
wlprnsth	prns
wlpyilim	pyl
wlpyilwt	pyl
wltpistn	tps
wlwqx	lqx
wlwxmi	lxm
wlxbr	xbr
wlxiwt	xii
wlytim	ytt
wmamr	amr
wmawrgn	argn
wmcd	cdd
wmdrik	drk
wmelxim	elx
wmenah	ena
wmeqrim	eqr
wmimwn	mmn
wmkeir	ker
wmmpqdi	pqd
wmmwek	mek
wmmycbi	ycb
wmngd	ngd
wmnxili	nxl
wmpni	pni
wmqwm	qwm
wmspr	spr
wmsqnh	nsq
wmsr	msr
wmstlqim	slq
wmstpqim	spq
wmtmid	tmd
wmtn	ntn
wmtncl	ncl
wmtsklt	tskl
wmtwskl	tskl
wmvbywt	vby
wmvynim	vyn
wmwlikim	ikl
wmwrkb	rkb
wmwwt	mwt
wmxr	mxr
wmycbi	ycb
wmyidim	ywd
wmyv	myv
wmywlm	ylm
wnawm	nam
wnbxri	bxr
wnbxrw	bxr
wncigihm	icg
wndre	dre
wnetdl	edl
wngd	ngd
wnipcw	npc
wnisiwn	nsi
wnisw	nsi
wniyrw	nyr
wnkny	kny
wnkwnwt	kwn
wnmlvw	mlv
wnpsiq	psq
wnqiim	qwm
wnwplim	npl
wnxt	nxt
wnycbnw	ycb
wpcy	pcy
wpgiyh	pgy
wpiqwx	pqx
wpqid	pqd
wprv	prv
wpwqd	pqd
wpwyli	pyl
wpxwt	pxt
wqbyh	qby
wqcini	qcn
wqdie	qde
wqhw	qhh
wqra	qra
wqvlnit	qvl
wqvyi	qvy
wqwry	qry
wraiit	rai
wrbim	rbb
wrcixtw	rcx
wrcnw	rwc
wrcx	rcx
wrcxw	rcx
wrewmwt	rem
wrgiewt	rge
wrwch	rci
wsgidh	sgd
wsgnitw	sgn
wsiimh	sim
wsmlim	sml
wswgrim	sgr
wsyd	syd
wtgwbwt	gwb
wtiirt	twr
wtqewrt	qer
wttpzr	pzr
wtwarw	tar
wtwkniwt	tkn
wxbriw	xbr
wxbrw	xbr
wxci	xci
wxeb	xeb
wxewb	xeb
wxiib	xwb
wxiil	xil
wxlilh	xll
wxlq	xlq
wxsri	xsr
wxweiw	xwe
wxzqim	xzq
wxzrti	xzr
wyd	wyd
wydh	wyd
wydiin	ydi
wydt	wyd
wyewiim	yei
wyidt	wyd
wyidwd	ydd
wyidwt	wyd
wyin	yin
wyini	yin
wyitwnaim	ytt
wyl	yli
wyliith	yli
wylilh	yll
wylth	yli
wymd	ymd
wyrwk	yrk
wyt	ytt
wywbrim	ybr
wywd	ywd
wzkh	zki
wzkrw	zkr
xbl	xbl
xblh	xbl
xbr	xbr
xbrh	xbr
xbri	xbr
xbrtit	xbr
xbrtiwt	xbr
xbrwt	xbr
xbvw	xbv
xbwe	xbe
xbwrh	xbr
xbwrt	xbr
xci	xci
xd	xdd
xde	xde
xdeh	xde
xdeim	xde
xdewt	xde
xdlh	xdl
xdr	xdr
xeb	xeb
xebh	xeb
xebti	xeb
xebw	xeb
xebwn	xeb
xebwnw	xeb
xebwnwt	xeb
xed	xed
xee	xee
xeibh	xeb
xeibwt	xeb
xeti	xwe
xew	xwe
xewb	xeb
xewd	xed
xgigit	xgg
xi	xii
xibh	xbb
xicwni	xwc
xicwniim	xwc
xicwnit	xwc
xih	xii
xiib	xib
xiibim	xwb
xiibt	xib
xiih	xii
xiihm	xii
xiikn	xik
xiili	xil
xiilim	xil
xiilwt	xil
xiim	xii
xilwni	xll
xilwniim	xll
xilwnim	xll
xilwpi	xlp
xinwk	xnk
xinwki	xnk
xipe	xpe
xipenw	xpe
xislh	xsl
xizwi	xzi
xizwqim	xzq
xkkw	xkk
xlewt	xle
xlh	xwl
xlilh	xll
xlli	xll
xlph	xlp
xlpw	xlp
xlq	xlq
xlqi	xlq
xlqim	xlq
xlqit	xlq
xlqm	xlq
xlwmwtiw	xlm
xlwn	xll
xlwnwt	xll
xlwpiwt	xlp
xlwpwt	xlp
xlwqt	xlq
xmieh	xme
xninh	xnn
xnwiwt	xni
xqirh	xqr
xqlai	xql
xqlaim	xql
xqlaiwt	xql
xqr	xqr
xrdim	xrd
xrdwt	xrd
xrigwt	xrg
xrm	xrm
xrph	xrp
xrwet	xre
xsid	xsd
xsidim	xsd
xsm	xsm
xsr	xsr
xsri	xsr
xsrim	xsr
xsrt	xsr
xsrwt	xsr
xt	axd
xvibt	xvb
xwbh	xwb
xwbqwt	xbq
xwc	xwc
xwde	xde
xwdei	xde
xwdeiim	xde
xwdeim	xde
xwee	xee
xwek	xek
xwmr	xmr
xwnwt	xni
xwpei	xpe
xwpeiim	xpe
xwq	xwq
xwqi	xwq
xwqiwt	xqq
xwqr	xqr
xwqrim	xqr
xwsr	xsr
xwtmt	xtm
xwwai	xwi
xwwih	xwi
xwzr	xzr
xwzrt	xzr
xzq	xzq
xzqh	xzq
xzqim	xzq
xzr	xzr
xzrh	xzr
xzrti	xzr
xzrw	xzr
xzw	xzi
xzwt	xzi
ybr	ybr
ybrh	ybr
ybriin	ybr
ybriinim	ybr
ybwdh	ybd
ybwdt	ybd
ybwdti	ybd
ybwdtk	ybd
ych	iyc
ycm	ycm
ycmai	ycm
ycmawtm	ycm
ycmh	ycm
ycmi	ycm
ycmit	ycm
ycmk	ycm
ycmm	ycm
ycmn	ycm
ycmnw	ycm
ycmw	ycm
ycr	ycr
ycrh	ycr
ycrti	ycr
ycrw	ycr
ycwb	ycb
ycwbh	ycb
ycwmwt	ycm
ycwr	ycr
ycwrim	ycr
ycwt	iyc
yd	ydi
ydiin	ydi
ydin	ydn
ydwiwt	ydi
ydwt	ydi
yeh	yei
yeirim	yer
yerim	yer
yerwt	yer
yeth	yei
yew	yei
yewi	yei
yewih	yei
yicwb	ycb
yicwmim	ycm
yiipwt	yip
yilai	yli
yilaiim	yli
yimwtim	ymt
yin	yin
yinh	yni
yinihm	yin
yiniim	yin
yiniw	yin
yiqr	yqr
yiriit	yir
yitwnai	ytt
yitwnaim	ytt
yitwnwt	ytt
yl	yli
ylh	yli
yli	yli
ylih	yli
ylihm	yli
ylik	yli
ylikm	yli
ylinw	yli
ylit	yli
yliw	yli
ylizim	ylz
ylwl	yll
ylwlim	yll
ymd	ymd
ymid	ymd
ymt	lywmt
ymwdi	ymd
ymwqh	ymq
yniin	yni
yniini	yni
ynq	ynq
ynqi	ynq
ynqit	ynq
ynth	yni
yqb	yqb
yqbwtiw	yqb
yqib	yqb
yqicwt	yqc
yrb	yrb
yrbi	yrb
yrbii	yrb
yrbim	yrb
yrbiwt	yrb
yrikt	yrk
yrk	yrk
yrkm	yrk
yrkw	yrk
yrlwt	yrl
yrwk	yrk
yrwkh	yrk
ysq	ysq
ysqh	ysq
ysqw	ysq
yt	ytt
yth	ytt
ytid	ytd
ytidm	ytd
ytiqim	ytq
yv	ywv
yvrh	yvr
ywbd	ybd
ywbdh	ybd
ywbdim	ybd
ywbdwt	ybd
ywbri	ybr
ywbrim	ybr
ywcmh	ycm
ywcmt	ycm
ywd	ywd
ywdd	ydd
ywddw	ydd
ywdw	ywd
ywin	yin
ywint	yin
ywinwt	yin
ywlim	ylh
ywlm	ylm
ywlmi	ylm
ywlmit	ylm
ywmd	ymd
ywmdt	ymd
ywnei	yne
ywnh	yni
ywrki	yrk
ywtqim	ytq
ywzr	yzr
yzbh	yzb
yzh	yzz
yzrh	yzr
zdwnit	zdn
zgwgiwt	zgg
zhrh	zhr
zhwt	zhi
zihwi	zhi
zikrwn	zkr
ziqtw	zqq
zit	zit
ziwwg	zwg
zkaim	zki
zkiitw	zki
zkit	zki
zkrm	zkr
zkrnw	zkr
zkrwnwt	zkr
zkw	zki
zkwiwt	zki
zkwiwtihm	zki
zkwt	zki
zmn	zmn
zmr	zmr
zqni	zqn
zr	zwr
zrh	zwr
zrim	zwr
zwb	zwb
zwkh	zki
zwkim	zki
zwkr	zkr
zwkwt	zkh
zwlim	zwl
