baʔofanáyim	ba^ʔofan^áyi^m
babanq	ba^banq
baboc	ba^boc
badli	ba^dli
badáqt	badáq^t
badélet	ba^délet
badéšeʔ	ba^déšeʔ
bagirím	ba^gir^í^m
baguf	ba^guf
bah	b^ah
bahawrudá	ba^ha^wrud^á
bahége	ba^hége
bakfafót	ba^kfaf^ó^t
bakinór	ba^kinór
bakiséʔ	ba^kiséʔ
bakos	ba^kos
bakviš	ba^kviš
baláxac	ba^láxac
balégo	ba^légo
baléxem	ba^léxem
balóni	balón^i
balúax	ba^lúax
balúm	balúm
bamagén	ba^magén
bamaqóm	ba^ma^qóm
bamaseḳá	ba^maseḳ^á
bamaʕalít	ba^maʕal^ít
bamaʕaréḳet	ba^ma^ʕaréḳ^et
bamaṭós	ba^maṭós
bamegeyrá	ba^me^geyr^á
bameʔurá	ba^me^ʔur^á
bamiḳsé	ba^mi^ḳsé
bamiṣxáq	ba^miṣxáq
bamiṭbáx	ba^miṭbáx
bamíqrogal	ba^mí^qrogal
banáʕal	ba^náʕal
bapeʔá	ba^peʔ^á
bapumpiyá	ba^pump^iy^á
bapázel	ba^pázel
bapérax	ba^pérax
baqbúq	baqbúq
baqibúc	ba^qibúc
baqufsá	ba^qufs^á
barexóv	ba^rexóv
barxá	barx^á
basabón	ba^sabón
basalón	ba^salón
basulám	ba^sulám
basábres	ba^sábres
baxacér	ba^xacér
baxalalít	ba^xalal^ít
baxipušít	ba^xipuš^ít
baxol	ba^xol
baxéder	ba^xéder
baxóref	ba^xóref
bayadáyim	ba^yad^áyi^m
baʔadóm	ba^ʔadóm
baʔargáz	ba^ʔargáz
baʔofnóaʕ	ba^ʔofnóaʕ
baʔor	ba^ʔor
baʔím	baʔ^ím
baʔórez	ba^ʔórez
baḳtá	baḳ^t^á
baṭiṭúl	ba^ṭiṭúl
baṭuš	ba^ṭuš
baṭévaʕ	ba^ṭévaʕ
bebahír	be^bahír
bebum	be^bum
bebéged	be^béged
bedargá	be^darg^á
bedaysá	be^days^á
begiréy	be^gir^éy
begérev	be^gérev
belimón	be^limón
bemaqél	be^maqél
bemaxboʔím	be^ma^xboʔ^í^m
benadnedót	be^nadned^ó^t
beneyár	be^neyár
bepáʕam	be^páʕam
beqišqúš	be^qišqúš
beqóṭeʝ	be^qóṭeʝ
beragláyim	be^ragl^áyi^m
beramzór	be^ramzór
berexóv	be^rexóv
beróṭev	be^róṭev
besabón	be^sabón
besulám	be^sulám
besálqal	be^sálqal
betiqwá	be^tiqw^á
bewídeʔo	be^wídeʔo
bexarúz	be^xarúz
bezaḳár	be^zaḳár
bezḳuḳít	be^zḳuḳ^ít
bešḳivá	be^šḳiv^á
beʔanglít	be^ʔangl^í^t
beʔoniyá	be^ʔon^iy^á
beʔárbaʕ	be^ʔárbaʕ
beʔérec	be^ʔérec
beʕacméḳ	be^ʕacm^é^ḳ
beṣaṣón	be^ṣaṣ^ón
beṭip	be^ṭip
biclilím	bi^clil^í^m
bicxóq	bi^cxóq
bidiyúq	bi^diyúq
bimyuxád	bi^m^yuxád
biqárnu	biqár^n^u
biqášt	biqáš^t
bišél	bišél
boním	bon^í^m
boqéaʕ	boqéaʕ
bor	bor
boxéret	boxér^et
boḳót	boḳ^ó^t
breyḳá	breyḳ^á
briʔá	briʔ^á
báflot	báfl^o^t
béduʔi	béduʔi
bérez	bérez
cadáqt	cadáq^t
camxú	camx^ú
cawáʔr	cawáʔr
caxaqá	caxaq^á
caʕacuʕím	caʕacuʕ^í^m
cfardéaʕ	cfardéaʕ
cibúr	cibúr
cirím	cir^í^m
ciyurím	ciyur^í^m
ciyárt	ciyár^t
cofár	cofár
corxím	corx^í^m
coréax	coréax
covʕím	covʕ^í^m
coxaqím	coxaq^í^m
coxéqet	coxéq^et
coʕéd	coʕéd
cuf	cuf
cʔi	cʔi
dafáq	dafáq
daysá	days^á
dilágti	dilág^ti
ding	ding
dmuy	dmuy
dofqím	dofq^í^m
dong	dong
fízit	fíz^it
gagót	gag^ó^t
galgalím	galgal^í^m
galgélet	galgél^et
gamúr	gamúr
garón	gar^ón
gaxliliyót	gaxlil^iy^ó^t
gazúr	gazúr
gdolá	gdol^á
giboréy	gibor^éy
gibór	gibór
gilú	gil^ú
gozezím	gozez^í^m
gréʕpsim	gréʕps^i^m
gufiyót	guf^iy^ót
gvohá	gvoh^á
gzirá	gzir^á
géfen	géfen
habadím	ha^bad^í^m
habgadím	ha^bgad^í^m
haboṭáni	ha^boṭán^i
habóyler	ha^bóyler
hacawaʔrón	ha^cawaʔr^ón
hacdadím	ha^cdad^í^m
hacmeʔím	ha^cmeʔ^í^m
hadag	ha^dag
hadalím	ha^dal^í^m
hadbaqót	ha^dbaq^ó^t
hadolfín	ha^dolfín
hadubá	ha^dub^á
hafuḳá	hafuḳ^á
hagagót	ha^gag^ó^t
hagamál	ha^gamál
hagarʕiním	ha^garʕin^í^m
hagibór	ha^gibór
hagóʕal	ha^góʕal
hahacaʕá	ha^hacaʕ^á
hahaftaʕá	ha^haftaʕ^á
hahitnašmuyót	ha^hit^našmuy^ó^t
hahitxayvút	ha^hit^xayv^út
hakadúr	ha^kadúr
hakapót	ha^kap^ó^t
hakaríš	ha^karíš
hakawaná	ha^kaw^an^á
hakazé	ha^kazé
hakeʔevím	ha^ke^ʔev^í^m
hakidón	ha^kidón
hakosót	ha^kos^ó^t
hakoḳavím	ha^koḳav^í^m
halanúax	ha^la^núax
halulaʔá	ha^lulaʔ^á
hamagášáḳ	ha^magáš^á^ḳ
hamaqél	ha^maqél
hamarvád	ha^ma^rvád
hamasmér	ha^ma^smér
hamaṭaʔṭéʔ	ha^ma^ṭaʔṭéʔ
hameforaqím	ha^me^foraq^í^m
hamet	ha^met
hamexilá	ha^me^xil^á
hameḳuná	ha^me^ḳuná
hamiqrím	ha^mi^qr^í^m
hamisdarón	ha^mi^sdar^ón
hamiznón	ha^mizn^ón
hamišbacót	ha^miš^bac^ó^t
hamiṣxáq	ha^mi^ṣxáq
hamlacá	ha^mlac^á
hamáwet	ha^máwet
hamíqrogal	ha^míqrogal
hanadnedót	ha^nadned^ó^t
hanadnéd	ha^nadnéd
hanaqníq	ha^naqníq
hanaším	ha^naš^í^m
hanigudím	ha^nigud^í^m
hapantér	ha^pantér
haprixá	ha^prix^á
hapázelim	ha^pázel^i^m
hapáʔzel	ha^páʔzel
hapélax	ha^pélax
hapéteq	ha^péteq
haqarnáf	ha^qarnáf
haqaṭár	ha^qaṭár
haqubiyót	haqub^iy^ó^t
haqur	ha^qur
haqáyic	ha^qáyic
haqódem	ha^qódem
haraqdanít	ha^raqd^an^ít
haréyax	ha^réyax
has	has
hasadín	ha^sadín
hasfarím	ha^sfar^í^m
hasimaním	ha^siman^í^m
hasod	ha^sod
hasukaryá	ha^sukar^y^á
hatapuzím	ha^tapuz^í^m
hatavlín	ha^ta^vlín
hatíras	ha^tíras
hawaród	ha^waród
haxadašót	ha^xadaš^ó^t
haxalaqím	ha^xalaq^í^m
haxalúq	ha^xalúq
haxamudót	ha^xamud^ó^t
haxamúdi	ha^xamúd^i
haxarucá	ha^xaruc^á
haxazír	ha^xazír
hayaréax	ha^yaréax
hayatúš	ha^yatúš
hayexidá	ha^yexid^á
hayáyin	ha^yáyin
hayítem	hayí^tem
hazaxál	ha^zaxál
hazgugít	ha^zgug^ít
hazoʔt	ha^zoʔt
hazébra	ha^zébr^a
hašar	ha^šar
hašarwúl	ha^šarwúl
hašaxór	ha^šaxór
hašel	ha^šel
hašimpánza	ha^šimpánz^a
hašováv	ha^šováv
haštey	ha^štey
hašéleg	ha^šéleg
hašémeš	ha^šémeš
hašóqo	ha^šóqo
haʔadumá	ha^ʔadum^á
haʔafór	ha^ʔafór
haʔagudál	ha^ʔa^gudál
haʔanaším	ha^ʔanaš^í^m
haʔanṭéna	ha^ʔanṭén^a
haʔargáz	ha^ʔargáz
haʔarón	ha^ʔar^ón
haʔaróḳ	ha^ʔaróḳ
haʔatá	ha^ʔat^á
haʔawirón	ha^ʔawir^ón
haʔaxayót	ha^ʔaxay^ó^t
haʔegozím	ha^ʔe^goz^í^m
haʔeyvarím	ha^ʔeyvar^í^m
haʔofanóaʕ	ha^ʔofanóaʕ
haʔoznáyim	ha^ʔozn^áyi^m
haʔárec	ha^ʔárec
haʔárṭiq	ha^ʔárṭiq
haʔélef	ha^ʔélef
haʔóḳel	ha^ʔóḳel
haʕagól	ha^ʕagól
haʕal	ha^ʕal
haʕanaqít	ha^ʕanaq^ít
haʕeynáyim	ha^ʕeyn^áyi^m
haʕiqarón	ha^ʕiqar^ón
haʕitón	ha^ʕit^ón
haʕécem	ha^ʕécem
haʕérev	ha^ʕérev
haṣaqiyót	haṣaq^iy^ó^t
haṣmalót	ha^ṣmal^ó^t
haṭifṭufím	ha^ṭifṭuf^í^m
haṭráqṭor	ha^ṭráqṭor
haṭéqsi	ha^ṭéqsi
haṭósṭer	ha^ṭósṭer
hecáct	he^các^t
hegyoní	hegyoní
hegíaʕ	he^gíʕ^a
hesbér	hesbér
hevéʔtem	hevéʔtem
hezázti	he^záz^ti
heʕárt	heʕár^t
heḳánti	heḳán^t^i
hicláxta	hi^cláx^ta
hicíq	hi^cíq
hidlíqu	hi^dlíq^u
hifxída	hi^fxíd^a
hipált	hipál^t
hipíl	hi^píl
hirgízu	hi^rgíz^u
histadárt	his^tadár^t
histaklí	his^takl^í
histovevú	his^tovev^ú
hitlaḳléḳ	hit^laḳléḳ
hitnahég	hi^tn^ahég
hitparqá	hit^parq^á
hitxílu	hi^txíl^u
hitʕamlút	hit^ʕaml^út
hivṭáxti	hi^vṭáx^ti
hištaná	hiš^taná
hišʔárt	hi^šʔár^t
hiḳnísu	hi^ḳnís^u
hocéʔt	hocéʔt
hops	hops
horéd	horéd
kapára	kapár^a
kapáyim	kap^áyi^m
karṭís	karṭís
katáv	katáv
kavúy	kavúy
kaʕasá	kaʕas^á
kibít	ki^bí^t
kisaʔót	kisaʔ^ó^t
kli	kli
klomár	klomár
kolél	kolél
kotvím	kotv^í^m
kulánu	kul^á^n^u
kvedá	kved^á
kétem	kétem
kéter	kéter
kóvaʕ	kóvaʕ
kšecomxót	k^še^comx^ó^t
kšehayíti	k^še^hayí^ti
kšemadliqím	k^še^ma^dliq^í^m
kšemakím	k^še^mak^í^m
kšemarbicím	k^še^ma^rbic^í^m
kšenigmór	k^še^ni^gmór
kšepáʕam	k^še^páʕam
kšetelḳí	k^še^te^lḳ^í
kšetesaymí	k^še^te^saym^í
kšeze	k^še^ze
kšeʔanáxnu	k^še^ʔanáx^n^u
labarwáz	la^barwáz
lacaʕacuʕím	la^caʕacuʕ^í^m
lacurá	la^cur^á
ladag	la^dag
ladod	la^dod
laglída	la^glíd^a
lagúr	la^gúr
lahén	la^hén
lakaf	la^kaf
lakarím	la^kar^í^m
lakis	la^kis
lakisaʔót	la^kisaʔ^ó^t
lamalbén	la^ma^lbén
lamalká	la^malk^á
lamesibá	la^me^sib^á
lamivné	la^mivn^é
lanadnedót	la^nadned^ó^t
lanaḳón	la^naḳ^ón
lanemalá	la^nemal^á
lapqaq	la^pqaq
lapsantér	la^psantér
laqirqás	la^qirqás
laqomá	la^qom^á
laqáxti	laqáx^ti
larúc	la^rúc
lasabónlehikanés	la^sabón^le^hi^kanés
lasandalím	la^sandal^í^m
lateʔúr	la^teʔúr
latšiʕí	la^tšiʕí
lawaród	la^waród
laxacót	la^xac^ót
laxalalít	la^xalal^ít
laxtóḳ	la^xtóḳ
laxóreš	la^xóreš
layadáyim	la^yad^áyi^m
laʔaf	la^ʔaf
laʔarnáv	la^ʔa^rnáv
laʔarón	la^ʔar^ón
laʔaxót	la^ʔax^ót
laʔilanót	la^ʔilan^ó^t
laʔóṭobus	la^ʔóṭobus
laʕir	la^ʕir
laʕozéret	la^ʕozér^et
laʕuf	la^ʕuf
laʕús	la^ʕús
laḳén	laḳén
laṭalé	la^ṭalé
laṭiyúl	la^ṭiyúl
lebiluyím	le^biluy^í^m
lebóʔi	le^bóʔi
lecafcéf	le^cafcéf
ledabér	le^dabér
ledagdég	le^dagdég
lehafríd	le^ha^fríd
lehamiṭá	le^ha^miṭ^á
lehaníax	le^ha^níax
lehasbír	le^ha^sbír
lehavhév	le^ha^vhév
lehavíʔ	le^havíʔ
lehayóm	le^ha^yóm
lehazmín	le^ha^zmín
lehazíz	le^hazíz
lehašlíḳ	le^ha^šlíḳ
lehicṭanén	le^hic^ṭanén
lehipacáʕ	le^hi^pacáʕ
lehistadér	le^his^tadér
lehitpocéc	le^hit^pocéc
lehitxaléq	le^hit^xaléq
lehizahér	le^hi^zahér
lelaparpár	le^la^parpár
lelev	le^lev
lemaqóm	le^ma^qóm
lematáy	le^matáy
lemiluʔím	le^mi^luʔ^í^m
lemáyim	le^máyim
lenašéq	le^našéq
lenerót	le^ner^ó^t
leniḳnasím	leni^ḳnas^í^m
leqarér	le^qarér
leqašqéš	le^qašqéš
lerégaʕ	le^régaʕ
lesayéd	le^sayéd
lesus	le^sus
letóḳ	le^tóḳ
letúkim	le^túk^i^m
levením	leven^í^m
lewaród	le^waród
lewehaláḳ	le^we^haláḳ
lexalalít	le^xalal^ít
lexasidá	le^xasid^á
lexayég	le^xayég
leyabév	le^yabév
leyeš	le^yeš
lešafáni	le^šaf^án^i
lešmóne	le^šmón^e
lešofár	le^šofár
lešulxán	le^šulx^án
lešémeš	le^šémeš
leʔadóm	le^ʔadóm
leʔaz	le^ʔaz
leʔibúd	le^ʔibúd
leʔor	le^ʔor
leʔémcaʕ	le^ʔémcaʕ
leʕacmí	le^ʕacm^í
leʕal	le^ʕal
leṭayél	le^ṭayél
leṭaʔṭéʔ	le^ṭaʔṭéʔ
li	l^i
libá	li^b^á
licróax	li^cróax
ligzór	li^gzór
linšóḳ	li^nšóḳ
litlót	li^tl^ót
livdóq	li^vdóq
livlóaʕ	li^vlóaʕ
lišón	li^š^ón
lišʔól	li^šʔól
lišṭóf	li^šṭóf
liḳléḳ	liḳléḳ
loxécet	loxéc^et
léḳi	léḳ^i
ma^lbén	ma^lbén
maclixím	ma^clix^ím
macáʔti	macáʔ^t^i
mad	mad
madbeqót	ma^dbeq^ó^t
maftexót	ma^ftex^ó^t
magafáyim	magaf^áyi^m
magbirá	ma^gbir^á
magišá	ma^giš^á
magnéṭ	magnéṭ
makirá	ma^kir^á
mamšíḳ	ma^mšíḳ
mapá	map^á
mapúxít	mapúx^ít
maqél	maqél
maráxt	maráx^t
marʔá	ma^rʔ^á
masbirá	ma^sbir^á
masbirím	ma^sbir^ím
masór	masór
maxboʔím	maxboʔ^í^m
mazmín	ma^zmín
maʕalít	maʕal^ít
maʕaróḳ	ma^ʕaróḳ
maḳín	ma^ḳín
maṭís	ma^ṭís
mebreyḳá	me^breyḳ^á
mecalaxót	me^calax^ó^t
mecalcél	me^calcél
mecalémet	me^calém^et
mecayrím	me^cayr^í^m
mecuyán	me^cuy^án
mecuyár	me^cuyár
mecíq	me^cíq
medabrót	me^dabr^ó^t
mefaréq	me^faréq
mefaxadím	me^faxad^í^m
mefuzarím	me^fuzar^í^m
megeyrá	me^geyr^á
megóva	me^góv^a
mehadaf	me^ha^daf
mehadag	me^ha^dag
mehadorbán	me^ha^dorb^án
mehahatxalá	me^ha^hatxal^á
mehakadúr	me^ha^kadúr
mehakos	me^ha^kos
mehamadáf	me^ha^madáf
mehamašderím	me^ha^mašder^í^m
mehaner	me^ha^ner
mehaqlipá	me^ha^qlip^á
mehaqumqúm	me^ha^qumqúm
mehatiqrá	me^ha^tiqr^á
mehaxayím	me^ha^xay^í^m
mehašerutím	me^ha^šerut^í^m
mehašuq	me^ha^šuq
mehašurá	me^ha^šur^á
mehaʔalbóm	me^ha^ʔalbóm
mehaʔawirón	me^ha^ʔawir^ón
mehaʔecbaʕót	me^ha^ʔecbaʕ^ó^t
mehaʔeš	me^ha^ʔeš
mehaʔiš	me^ha^ʔiš
mehaʔofnóaʕ	me^ha^ʔofnóaʕ
mehaʕarisá	me^ha^ʕaris^á
mehaʕeynáyim	me^ha^ʕeyn^áyi^m
mehaʕizím	me^ha^ʕiz^í^m
mehem	me^hem
mekirím	me^kir^í^m
mekésef	me^késef
melaméd	me^laméd
melaqeqím	me^laqeq^í^m
melaṭfím	me^laṭf^í^m
meluxím	me^lux^í^m
memášehu	me^má^še^hu
menafnéf	me^nafnéf
mequlafím	me^qulaf^í^m
meraxréax	me^raxréax
mesaprím	me^sapr^í^m
mesovév	me^sovév
mesábresim	me^sábres^i^m
metaʔéret	me^taʔér^et
metuqán	me^tuqán
mevaqéšet	me^vaqéš^et
meviʔá	me^viʔ^á
mevugéret	me^vugér^et
mexabrím	me^xabr^í^m
mexom	me^xom
meyuxédet	me^yuxéd^et
mezḳuḳít	me^zḳuḳ^ít
mešafšéfet	me^šafšéf^et
mešugáʕ	me^šugáʕ
mešutéfet	me^šutéf^et
mešuxréret	me^šuxrér^et
meʔambáṭya	me^ʔambáṭ^y^a
meʔaxoráy	me^ʔaxor^áy
meʔaxóra	me^ʔaxór^a
meʔunivérsiṭa	me^ʔunivérsiṭ^a
meʔuxéret	me^ʔuxér^et
meʔéyze	me^ʔéyze
meʕacbénet	me^ʕacbén^et
meʕagvaniyá	me^ʕagv^an^iy^á
meʕagvaniyót	me^ʕagv^an^iy^ó^t
meʕal	me^ʕal
meḳawéc	me^ḳawéc
meḳawén	me^ḳawén
meḳiná	me^ḳin^á
meḳinót	me^ḳin^ó^t
meḳín	me^ḳín
meṣaxéq	me^ṣaxéq
meṭayél	me^ṭayél
meṭriqó	meṭriqó
mibeyn	mi^beyn
micṭaʕéret	mic^ṭaʕér^et
migdál	mi^gdál
mikxolím	mi^kxol^í^m
misparím	mi^spar^í^m
mispár	mi^spár
mistalqím	mis^talq^í^m
mistatéret	mis^tatér^et
mistovév	mis^tovév
mit^nadned^ím	mi^tnadned^ím
mitgaléš	mit^galéš
mithapéḳ	mit^hapéḳ
mitlahévet	mit^lahév^et
mitlaqéqet	mit^laqéq^et
mitnaqé	mit^naqé
mitragéz	mit^ragéz
mitxabʔót	mit^xabʔ^ó^t
mityabéšet	mit^yabéš^et
mišqaféy	mi^šqaf^éy
mištalém	miš^talém
mištamším	miš^tamš^í^m
mištaʕél	miš^taʕél
mišóqo	mi^šóqo
mišṭará	miš^ṭar^á
miḳnasáyim	mi^ḳnas^áyi^m
miḳtáv	mi^ḳtáv
mociʔím	mociʔ^í^m
mocéʔ	mocéʔ
movilá	movil^á
mošíṭ	mošíṭ
munáx	munáx
muvaním	muvan^í^m
mušláḳ	mu^šláḳ
máyim	máy^i^m
mét	mét
míqrofon	míqrofon
míšehu	míšeh^u
n	n^a^ḳ
nadnedót	nadned^ó^t
nalbíš	na^lbíš
naníax	na^níax
nanʕíl	na^nʕíl
narbíc	na^rbíc
narív	na^rív
natná	natn^á
natxíl	na^txíl
naxšóv	na^xšóv
nazmín	na^zmín
naším	na^š^í^m
naʕalé	na^ʕalé
naʕaṣé	naʕaṣ^é
nehedéret	nehedér^et
nenasé	ne^nasé
neqevá	neqev^á
nesadér	ne^sadér
nexabér	ne^xabér
nexnáq	ne^xnáq
nexšáv	ne^xšáv
nešiqá	ne^šiq^á
neʕelmú	ne^ʕelm^ú
neʕelám	ne^ʕelám
neʕimá	ne^ʕim^á
nidbáqt	nidbáq^t
nidmé	nidmé
nifgáš	nifgáš
nifrós	ni^frós
nigudím	nigud^í^m
nihiyé	ni^hiyé
nimcéʔt	nimcéʔt
nimtáx	ni^mtáx
niqtá	ni^qtá
nirxóc	ni^rxóc
nistá	nis^t^á
nitgalgél	nit^galgél
nitlabéš	nit^labéš
nitpesá	ni^tpes^á
nitqeʕá	ni^tqeʕ^á
nizherá	ni^zher^á
nizhár	ni^zhár
nizkerá	ni^zker^á
nizreqú	ni^zreq^ú
niḳnás^ti	ni^ḳnás^ti
nofélet	no^fél^et^eḳ^á
nohagím	nohag^í^m
nohég	no^hég
nosʕím	no^sʕ^í^m
nosʕót	no^sʕ^ó^t
notén	no^tén
nošémet	no^šém^et
noṣéʔ	no^ṣéʔ
náxa	náx^a
náylon	náylon
núdniq	núdniq
núdniqit	núdniq^it
pagášt	pagáš^t
pagšú	pagš^ú
pantér	pantér
parq	parq
patáxnu	patáx^n^u
patúax	patúax
paxadá	paxad^á
paxdá	paxd^á
paṭíš	paṭíš
pizárt	pizár^t
pomelít	pomel^ít
poxéd	poxéd
pqax	pqax
pqidá	pqid^á
ptitím	ptit^í^m
ptuxím	ptux^í^m
páṭifon	páṭif^on
qafácnu	qafác^n^u
qafáct	qafác^t
qamt	qam^t
qaróv	qaróv
qasṭanyéṭot	qasṭanyéṭ^o^t
qaw	qaw
qce	qce
qeʕará	qeʕar^á
qiblá	qibl^á
qilqél	qilqél
qiláft	qiláf^t
qipált	qipál^t
qišqešú	qišqeš^ú
qorím	qor^í^m
qosém	qosém
qronót	qron^ó^t
qur	qur
qušiyót	quš^iy^ó^t
qáqa	qáq^a
qécef	qécef
qúmi	qúm^i
qšurá	qšur^á
racím	rac^í^m
racíta	rací^ta
ragláyim	ragl^áyi^m
ragláyiḳ	ragl^áyi^ḳ
rakévet	rakév^et
raqafót	raqaf^ó^t
raqéṭa	raqéṭ^a
raxóq	raxóq
raʔínu	raʔí^n^u
raʕašán	raʕaš^án
rexóv	rexóv
rešimá	rešim^á
reṭuvót	reṭuv^ó^t
rocót	roc^ó^t
roféʔ	roféʔ
rácnu	rác^n^u
ráʕal	ráʕal
réseq	réseq
róṭev	róṭev
sadín	sadín
saf	saf
safrá	safr^á
sagrú	sagr^ú
sandlarím	sandlar^í^m
sevivón	seviv^ón
sgor	sgor
sgulót	sgul^ó^t
simán	sim^án
sinár	sinár
slil	slil
sodót	sod^ó^t
sofó	sof^ó
sotémet	sotém^et
sovevá	sovev^á
susím	sus^í^m
swéṭšerṭ	swéṭšerṭ
súper	súper
tadbíqi	ta^dbíq^i
tadlíq	ta^dlíq
tagzími	ta^gzím^i
taltál	taltál
tapuzím	tapuz^í^m
taqšívi	ta^qšív^i
taríxi	ta^ríx^i
tarúci	ta^rúc^i
tavín	ta^vín
taxaná	taxan^á
taxfóf	ta^xfóf
taxteḳí	ta^xteḳ^í
tašir	ta^šir
taʕaṣí	ta^ʕaṣ^í
taʕír	ta^ʕír
taʕíri	ta^ʕír^i
taṣím	ta^ṣ^ím
tecafcéf	te^cafcéf
tefarqí	te^farq^í
telamdí	te^lamd^í
telaqeqí	te^laqeq^í
tenagní	te^nagn^í
teqalqél	te^qalqél
teqarví	te^qarv^í
tesaréq	te^saréq
teʔavón	te^ʔavón
teʕarbév	te^ʕa^rbév
ticʕaqí	ti^cʕaq^í
tidʔagí	ti^dʔag^í
tifgeší	ti^fgeš^í
tiftexí	ti^ftex^í
timdedí	ti^mded^í
tiqrá	ti^qr^á
tisáʕ	ti^sáʕ
titfesí	ti^tfes^í
titní	ti^tn^í
titqarér	tit^qarér
tivké	ti^vké
tivxór	ti^vxór
tišté	ti^šté
tišʔalí	ti^šʔal^í
tišʕá	tišʕ^á
tiḳʕasí	ti^ḳʕas^í
tiḳʕás	ti^ḳʕás
tiṣmáx	ti^ṣmáx
tofsím	tofs^í^m
toʔḳlú	to^ʔḳl^ú
trufá	truf^á
tuḳál	tu^ḳál
táyiš	táyiš
túkim	túk^i^m
umargišá	u^ma^rgiš^á
umeʔayémet	u^me^ʔayém^et
waloʔ	wa^loʔ
webacel	we^ba^cel
webaʔ	we^baʔ
wecarxá	we^carx^á
wecipór	we^cipór
wedaqím	we^daq^í^m
wegam	we^gam
wegamárnu	we^gamár^n^u
wehabaqbúq	we^ha^baqbúq
wehaciporím	we^ha^cipor^í^m
wehacipór	we^ha^cipór
wehakapít	we^ha^kap^ít
wehaqacé	we^ha^qacé
wehasus	we^ha^sus
wehayediʕá	we^ha^yediʕ^á
wehazáxal	we^ha^záxal
wehaʔafór	we^ha^ʔafór
wehaʔišá	we^ha^ʔiš^á
weheyḳán	we^heyḳ^án
wehistakálti	we^his^takál^ti
wehitparéq	we^hit^paréq
wehitʕaṭášt	we^hit^ʕaṭáš^t
wekazé	we^kazé
weklum	we^klum
wekol	we^kol
wekulánu	we^kul^án^u
wekšetigmerí	we^k^še^ti^gmer^í
welabáyit	we^la^báyit
weladaléqet	we^la^daléq^et
welamáyim	we^la^máyim
welayaldá	we^la^yald^á
welaḳén	we^laḳén
weleqašéṭ	we^le^qašéṭ
weleycán	we^le^yc^án
welitpós	we^li^tpós
welišpóḳ	we^li^špóḳ
wemarkivá	we^ma^rkiv^á
wemaḳnisím	we^ma^ḳnis^í^m
wemelafefón	we^me^lafef^ón
wemesudár	we^me^sudár
wemetuqá	we^me^tuq^á
wemexaké	we^me^xaké
wenaflú	we^nafl^ú
wenafál	we^nafál
wenaqí	we^naqí
wenaʕím	we^naʕím
wenedabér	we^ne^dabér
wenevaqér	we^ne^vaqér
weniclá	we^nicl^á
wenipól	we^nipól
wenirʔé	we^ni^rʔé
wenitén	we^ni^tén
weniyarót	we^ni^yar^ó^t
wenišberá	we^nišber^á
wenišuqím	we^nišuq^í^m
wenoráʔ	we^no^ráʔ
wepar	we^par
weqaw	we^qaw
weqax	we^qax
weqiblá	we^qibl^á
werakévet	we^rakév^et
weraqíq	we^raqíq
wereviʕí	we^reviʕ^í
weroqdím	we^roqd^í^m
weséreṭ	we^séreṭ
wetaqlíṭi	we^ta^qlíṭ^i
wetarnegól	we^tarnegól
wetavíʔi	we^ta^víʔi
wetecayrí	we^te^cayr^í
wetelaqéq	we^te^laqéq
wetenagví	we^te^nagv^í
wetesadrí	we^te^sadr^í
wetimtexí	we^ti^mtex^í
wetitní	we^ti^tn^í
wetizreqí	we^ti^zreq^í
wetiškeví	we^ti^škev^í
wetišteqí	we^ti^šteq^í
wetištú	we^ti^št^ú
wexašávti	we^xašáv^ti
wexipáṣti	we^xipáṣ^ti
wexosmót	we^xosm^ó^t
wexéleq	we^xéleq
weyacáʔ	we^yacáʔ
weyeléḳ	we^yeléḳ
weyotér	we^yotér
wezo	we^zo
wešehayá	we^še^hayá
wešehuʔ	we^še^huʔ
wešoʔél	we^šoʔél
wešoṭéf	we^šoṭéf
wešémeš	we^šémeš
weʔadamá	we^ʔadam^á
weʔamrá	we^ʔamr^á
weʔanaším	we^ʔanaš^í^m
weʔanʕíl	we^ʔa^nʕíl
weʔasúr	we^ʔasúr
weʔaxér	we^ʔaxér
weʔe	we^ʔe
weʔomrím	we^ʔomr^í^m
weʔuláy	we^ʔuláy
weʔécbaʕ	we^ʔécbaʕ
weʔéfes	we^ʔéfes
weʔéyze	we^ʔéyze
weʕad	we^ʕad
weʕaḳšáyw	we^ʕaḳš^áyw
weʕecím	we^ʕec^í^m
weʕeṣrím	we^ʕeṣr^ím
weʕizá	we^ʕiz^á
weʕoṣá	we^ʕoṣá
weṭov	we^ṭov
wáflim	wáfl^i^m
wáʔu	wáʔ^u
xacér	xacér
xafefá	xafef^á
xafáft	xafáf^t
xanayá	xanay^á
xaríc	xaríc
xatulím	xatul^í^m
xavál	xavál
xayalím	xayal^í^m
xaydaqím	xaydaq^í^m
xazáq	xazáq
xazárti	xazár^ti
xašód	xašód
xaḳamá	xaḳam^á
xaṭáf	xaṭáf
xec	xec
xemʔá	xemʔ^á
xikíta	xikí^ta
xitúl	xitúl
xolé	xolé
xomarím	xomar^í^m
xorím	xor^í^m
xotḳím	xotḳ^í^m
xová	xov^á
xulcót	xulc^ó^t
xuršá	xurš^á
xével	xével
yacív	ya^cív
yacʔú	ya^cʔú
yadúaʕ	ya^dúaʕ
yafríaʕ	ya^fríaʕ
yagídu	ya^gíd^u
yamšíḳ	ya^mšíḳ
yarád	yarád
yavíʔ	ya^víʔ
yaxfóf	ya^xfóf
yaxéf	yaxéf
yaxíd	yaxíd
yašánti	yaš^án^ti
yaʕavrú	ya^ʕavr^ú
yaʕaṣé	ya^ʕaṣé
yaʕíf	ya^ʕíf
yaḳlá	yaḳl^á
yecalcél	ye^calcél
yecʔú	ye^cʔú
yegaréd	ye^garéd
yelaḳléḳ	ye^laḳléḳ
yeqalqelú	ye^qalqel^ú
yeqará	ye^qar^á
yeradém	ye^radém
yeruqím	yeruq^í^m
yexaké	ye^xaké
yexidá	yexid^á
yešením	yešen^ím
yeʕalvú	ye^ʕalv^ú
yicṭanén	yic^ṭanén
yidaléq	yi^daléq
yidhár	yi^dhár
yigdelú	yi^gdel^ú
yikansú	yi^kans^ú
yipól	yi^pól
yistovév	yis^tovév
yitparéq	yit^paréq
yitxatén	yit^xatén
yizké	yi^zké
yišabrú	yi^šabr^ú
yišaʔér	yi^šaʔér
yišbór	yi^šbór
yiḳʔáv	yi^ḳʔáv
yiḳʕasú	yi^ḳʕas^ú
yiṭróf	yi^ṭróf
zaráqt	zaráqtám
zolgót	zolg^ó^t
zoxél	zoxél
zug	zug
zvuv	zvuv
zébrot	zébr^o^t
çípsim	çíps^i^m
šafáḳta	šafáḳ^ta
šalóm	šalóm
šamáʕt	šamáʕ^t
šanáʔy	šanáʔy
šayaḳím	šayaḳ^í^m
šayéḳet	šayéḳ^et
šebanáʕal	še^ba^náʕal
šebaweʔaní	še^ba^we^ʔaní
šebecoxaqím	še^be^coxaq^í^m
šebeséder	še^be^séder
šebo	še^b^o
šebáʔu	še^báʔ^u
šecivʕoní	še^civʕon^í
šecévaʕ	še^cévaʕ
šegamárnu	še^gamár^n^u
šehadmaʕót	še^ha^dmaʕ^ó^t
šehalev	še^ha^lev
šehamagévet	še^ha^magév^et
šeharoféʔ	še^ha^roféʔ
šehasnaʔí	še^ha^snaʔ^í
šehasúper	še^ha^súper
šehatiqún	še^ha^tiqún
šehayanšúf	še^ha^yanšúf
šehayéled	še^ha^yéled
šehaʝiráfa	še^ha^ʝiráf^a
šehaṭelewízya	še^ha^ṭelewízy^a
šehem	še^he^í^m
šehirkávti	še^hi^rkáv^ti
šeholḳím	še^holḳ^í^m
šekedáʔy	še^ke^dáʔy
šelaléḳet	še^la^léḳ^et
šelaqlemanṭína	še^la^qlemanṭín^a
šelesávtaʔ	še^le^sávtaʔ
šemagíaʕ	še^ma^gíaʕ
šemar	še^mar
šemaxziqá	še^ma^xziq^á
šemecafcéfet	še^me^cafcéf^et
šemeʕál	še^me^ʕál
šemiqódem	še^mi^qódem
šemisavív	še^mi^savív
šemistaklím	še^mis^takl^í^m
šemitnagšót	še^mit^nagš^ó^t
šemištolelím	še^miš^tolel^í^m
šemuqláṭ	še^mu^qláṭ
šemášehu	še^má^še^hu
šeneṣaméax	še^ne^ṣaméax
šeniqráʔ	še^ni^qráʔ
šenoráʔ	še^noráʔ
šenu	šen^u
šeparást	še^parás^t
šeqafácta	še^qafác^ta
šeracít	še^rací^t
šeracíta	še^rací^ta
šerocá	še^rocá
šetafsíqi	še^ta^fsíq^i
šetaníxi	še^ta^níx^i
šetarím	šeta^r^í^m
šetastír	še^ta^stír
šetebalbelí	še^te^balbel^í
šetedabér	še^te^dabér
šetesaprí	še^te^sapr^í
šetihiyé	še^ti^hiyé
šetiqreʔí	še^ti^qreʔ^í
šetišpeḳí	še^ti^špeḳ^í
šetišví	še^ti^šv^í
šeyacáʔ	še^ya^cáʔ
šeyaʕazór	še^ya^ʕazór
šeyaṣím	še^ya^ṣím
šeyesapér	še^ye^sapér
šeyiqráʔ	še^yi^qráʔ
šeyizxalú	še^yi^zxal^ú
šeyiṭróf	še^yi^ṭróf
šeyiṭʕám	še^yi^ṭʕám
šeyocéʔ	še^yocéʔ
šeyófi	še^yófi
šešavárta	še^šavár^ta
šeʔanaším	še^ʔanaš^í^m
šeʔasúr	še^ʔasúr
šeʔelá	še^ʔel^á
šeʕaṭáft	še^ʕaṭáf^t
šeʕocmím	še^ʕocm^í^m
šeʕod	še^ʕod
šeʕovéd	še^ʕovéd
širyón	širy^ón
šiḳvá	šiḳv^á
šliší	šliší
šloším	šloš^ím
šniyím	šniy^í^m
šováv	šováv
šovér	šovér
šoxéṭ	šoxéṭ
štoq	štoq
švurót	švur^ó^t
šéver	šéver
ʔadirá	ʔadir^á
ʔadumím	ʔadum^í^m
ʔagíd	ʔa^gíd
ʔamaléʔ	ʔa^maléʔ
ʔaní	ʔa^ní
ʔaqarér	ʔa^qarér
ʔaqṭín	ʔa^qṭín
ʔarnavéyha	ʔa^rnav^éyh^a
ʔarukím	ʔaruk^í^m
ʔarúc	ʔa^rúc
ʔavaním	ʔav^an^í^m
ʔaxidá	ʔaxid^á
ʔaxlíf	ʔa^xlíf
ʔaxlíš	ʔa^xlíš
ʔaxréy	ʔaxr^éy
ʔaxzíq	ʔa^xzíq
ʔaxzór	ʔa^xzór
ʔaxéret	ʔaxér^et
ʔaxíḳ	ʔax^í^ḳ
ʔayál	ʔayál
ʔazmín	ʔa^zmín
ʔašmaténu	ʔašm^atén^u
ʔašxíl	ʔa^šxíl
ʔecleḳém	ʔecle^ḳém
ʔeclí	ʔecl^í
ʔedafdéf	ʔe^dafdéf
ʔefróax	ʔe^fróax
ʔefšár	ʔe^fšár
ʔelaméd	ʔe^laméd
ʔelegánṭ	ʔelegánṭ
ʔelxác	ʔe^lxác
ʔemdód	ʔe^mdód
ʔemzóg	ʔe^mzóg
ʔenʕál	ʔe^nʕál
ʔeqanéax	ʔe^qanéax
ʔeqlóf	ʔe^qlóf
ʔerxác	ʔe^rxác
ʔespór	ʔe^spór
ʔestakél	ʔes^takél
ʔestaréq	ʔes^taréq
ʔetxatén	ʔet^xatén
ʔetʕarév	ʔet^ʕarév
ʔeyn	ʔeyn
ʔešʔáv	ʔe^šʔáv
ʔeʕené	ʔe^ʕené
ʔeʕevór	ʔe^ʕevór
ʔeṣaxéq	ʔe^ṣaxéq
ʔeṭróf	ʔe^ṭróf
ʔitám	ʔitám
ʔoḳál	ʔo^ḳál
ʔoḳélet	ʔoḳél^et
ʔuy	ʔuy
ʔánu	ʔá^n^u
ʔárbaʕ	ʔá^rbaʕ
ʔéyzo	ʔéyzo
ʔórez	ʔórez
ʔózen	ʔózen
ʔóḳel	ʔóḳel
ʕacmí	ʕacm^í
ʕad	ʕad
ʕagalgál	ʕagalgál
ʕagalá	ʕagal^á
ʕagvaniyá	ʕagv^aniy^á
ʕal	ʕal
ʕaleyhén	ʕal^eyhén
ʕaleyḳém	ʕal^eyḳém
ʕalizá	ʕaliz^á
ʕaltá	ʕal^t^á
ʕalá	ʕal^á
ʕaléyha	ʕal^éyh^a
ʕaléyḳa	ʕal^éy^ḳ^a
ʕalím	ʕal^í^m
ʕalúl	ʕalúl
ʕamdá	ʕamd^á
ʕamádeta	ʕamáde^ta
ʕaqšanít	ʕaqš^an^í^t
ʕasúq	ʕasúq
ʕavrú	ʕavr^ú
ʕavádet	ʕavád^et
ʕavé	ʕavé
ʕazáv	ʕazáv
ʕec	ʕec
ʕelyón	ʕely^ón
ʕeynéyḳa	ʕeyn^éy^ḳ^a
ʕeynó	ʕeyn^ó
ʕez	ʕez
ʕolám	ʕolám
ʕomdím	ʕomd^ím
ʕozér	ʕozér
ʕugiyót	ʕug^iy^ó^t
ʕáfu	ʕáf^u
ʕáyin	ʕáyin
ʕémeq	ʕémeq
ʕéṣer	ʕéṣer
ʕógen	ʕógen
ṣamt	ṣam^t
ṣamáxti	ṣamáx^ti
ṣaqiqéy	ṣaqiq^éy
ṣaqiyót	ṣaq^iy^ó^t
ṣaqéy	ṣaq^éy
ṣeʕarót	ṣeʕar^ó^t
ṣimlát	ṣimlát
ṣixaqú	ṣixaq^ú
ṣmiḳá	ṣmiḳ^á
ṣímu	ṣím^u
ṭabáx	ṭabáx
ṭamánu	ṭamá^n^u
ṭovélet	ṭovél^et
ṭélefon	ṭélefon
ṭúšim	ṭúš^i^m
