abnim	ab^n^i^m
acli	acl^i
aclikm	acl^km
adirh	adir^h
adpdp	a^dpdp
adwmim	adwm^i^m
aeab	a^eab
aemtnw	aem^tn^w
aexil	a^exil
aexq	a^exq
agid	a^gid
ai	a^i
ail	ail
ain	ain
aizw	aizw
algnv	algnv
almd	a^lmd
alxc	a^lxc
amdwd	a^mdwd
amla	a^mla
amzwg	a^mzwg
ani	ani
anw	a^n^w
anyl	a^nyl
aper	a^per
aprwx	aprwx
aqlwp	a^qlwp
aqnx	a^qnx
aqrr	a^qrr
aqvin	a^qvin
arby	a^rby
arnbih	a^rnb^ih^
arwc	a^rwc
arwkim	arwk^i^m
arxc	a^rxc
aspwr	a^spwr
astkl	a^stkl
astrq	a^strq
atxtn	a^txtn
atyrb	a^tyrb
avrwp	a^vrwp
awi	awi
awkl	awkl
awklt	awkl^t
awrz	awrz
awzn	awzn
axidh	a^xid^h
axik	ax^i^k
axlie	a^xlie
axlip	a^xlip
axri	axr^i
axrt	axr^t
axziq	a^xziq
axzwr	a^xzwr
aybwr	a^ybwr
aynh	a^ynh
azmin	a^zmin
badwm	b^adwm
baim	baim
banglit	b^angl^i^t
barby	b^arby
barc	b^arc
bargz	b^argz
bawniih	b^awni^i^h
bawpniim	b^awpn^ii^m
bawpnwy	b^awpnwy
bawr	b^awr
bawrz	b^awrz
bbcllim	bb^cll^i^m
bbgd	b^bgd
bbhir	b^b^hir
bbmiwxd	bb^m^iwxd
bbnq	b^bnq
bbwc	b^bwc
bbwm	b^bwm
bcxwq	b^cxwq
bdea	b^dea
bdiish	b^diis^h
bdiwq	b^diwq
bdli	b^dli
bdlt	b^dlt
bdqt	bdq^t
bdrgh	b^drg^h
bdwai	bdwai
beewn	b^ee^wn
bekbh	b^ekb^h
bel	b^el
bgirim	b^gir^i^m
bgrb	b^grb
bgri	b^gr^i
bgwp	b^gwp
bh	b^h
bhgh	b^hgh
bhwrdh	b^h^wrd^h
bidiim	b^id^ii^m
biqet	biqe^t
biqrnw	biqr^n^w
bkbe	b^kbe
bkinwr	b^kinwr
bkisa	b^kisa
bkppwt	b^kpp^w^t
bkth	bk^t^h
bkws	b^kws
blbdwq	b^l^bdwq
blbh	b^l^bh
blblwy	b^l^blwy
blcrwx	b^l^crwx
bleawl	b^l^eawl
blevwp	b^l^evwp
blewn	bl^e^wn
blgw	b^lgw
blgzwr	b^l^gzwr
blimwn	b^lmwn
blklk	b^l^klk
blnewk	b^l^newk
blwm	blwm
blwni	blwn^i
blwx	b^lwx
blxc	b^lxc
blxm	b^lxm
bmawrh	b^m^awr^h
bmexq	b^mexq
bmgirh	b^m^gir^h
bmgn	b^mgn
bmiqrwgl	b^mi^qrwgl
bmks	b^m^ks
bmql	b^mql
bmqwm	b^m^qwm
bmskh	b^msk^h
bmvbx	b^mvbx
bmvws	b^mvws
bmxbwaim	b^m^xbwa^i^m
bmylit	b^myl^it
bmyrkt	b^m^yrk^t
bndndwt	b^ndnd^w^t
bnir	b^nir
bnyl	b^nyl
bpah	b^pa^h
bplwt	bpl^w^t
bprx	b^prx
bpwmpiih	b^pwmp^ii^h
bpym	b^pym
bpzl	b^pzl
bqbwq	bqbwq
bqibwc	b^qibwc
bqieqwe	b^qieqwe
bqwpsh	b^qwps^h
bqwvg	b^qwvg
brah	bra^h
brgliim	b^rgl^ii^m
brikh	brik^h
brmzwr	b^rmzwr
brwvb	b^rwvb
brxh	brx^h
brxwb	b^rxwb
brz	brz
bsbrs	b^sbrs
bsbwn	b^sbwn
bslql	b^slql
bslwn	b^slwn
bswlm	b^swlm
btqwh	b^tqw^h
bvby	b^vby
bvip	b^vip
bvivwl	b^vivwl
bvwe	b^vwe
bwkwt	bwk^w^t
bwnim	bwn^i^m
bwqy	bwqy
bwr	bwr
bwwidaw	b^widaw
bwxrt	bwxr^t
bxcr	b^xcr
bxdr	b^xdr
bxipweit	b^xipwe^it
bxllit	b^xll^it
bxrwz	b^xrwz
bxwl	b^xwl
bxwrp	b^xwrp
bycmk	b^ycm^k
bzkr	b^zkr
bzkwkit	b^zkwk^it
cai	cai
cdqt	cdq^t
cibwr	cibwr
ciirt	ciir^t
cipsim	cips^i^m
ciwrim	ciwr^i^m
cmxw	cmx^w
cprdy	cprdy
crim	cr^i^m
cwbyim	cwby^i^m
cwp	cwp
cwpr	cwpr
cwrx	cwrx
cwrxim	cwrx^i^m
cwwar	cwar
cwxqim	cwxq^i^m
cwxqt	cwxq^t
cwyd	cwyd
cxqh	cxq^h
cycwyim	cycwy^i^m
dbqt	dbq^t
diish	diis^h
dmwi	dmwi
dng	dng
dpq	dpq
dti	d^^ti
dwng	dwng
dwpqim	dwpq^i^m
ealh	e^al^h
eaneim	e^ane^i^m
easwr	e^aswr
ebaw	e^ba^w
ebcwxqim	e^b^cwxq^i^m
ebnyl	e^b^nyl
ebr	ebr
ebsdr	e^b^sdr
ebw	e^b^w
ebwani	e^b^w^ani
ebwrwt	ebwr^w^t
ecby	e^cby
ecbywni	e^cbywn^i
eebrt	e^ebr^t
egmrnw	e^gmr^n^w
ehdmywt	e^h^dmy^w^t
ehgih	e^hgi^h
ehild	e^h^ild
ehinewp	e^h^inewp
ehlb	e^h^lb
ehm	e^h^i^m
ehmgbt	e^h^mgb^t
ehrkbti	e^h^rkb^ti
ehrwpa	e^h^rwpa
ehsnai	e^h^sna^i
ehswpr	e^h^swpr
ehtiqwn	e^h^tiqwn
ehvlwwizih	e^h^vlwizi^h
ehwlkim	e^hwlk^i^m
eica	e^ica
eieim	e^i^eim
eiikt	eiik^t
eikim	eik^i^m
eimw	eim^w
eiqra	e^i^qra
eispr	e^i^spr
eivrwp	e^i^vrwp
eivym	e^i^vym
eiwca	e^iwca
eiwpi	e^iwpi
eixqw	e^ixq^w
eiyzwr	e^i^yzwr
eizxlw	e^i^zxl^w
ekbh	ekb^h
ekdai	e^k^dai
elei	elei
ellkt	e^l^lk^t
elqlmnvinh	e^l^qlm^nvin^h
elsbta	e^l^sbta
elweim	elwe^i^m
elwm	elwm
emcpcpt	e^m^cpcp^t
emehw	e^m^e^hw
emetwllim	e^me^twll^i^m
emgiy	e^m^giy
emiqwdm	e^mi^qwdm
emkh	emk^h
emlt	emlt
emr	e^mr
emsbib	e^m^sbib
emstklim	e^ms^tkl^i^m
emt	em^t
emtngewt	e^m^tnge^w^t
emwqlv	e^mw^qlv
emxti	emx^ti
emxziqh	e^m^xziq^h
emyl	e^m^yl
emyt	emy^t
enai	enai
enemx	e^n^emx
eniim	en^i^i^m
enw	en^w
enwra	e^nw^ra
epkt	epk^t
eprst	e^prs^t
eqi	eq^i
eqiqi	eqiq^i
eqiwt	eq^i^w^t
eqpct	e^qpc^t
eqra	e^^qra
ercit	e^rci^t
eriwn	eri^wn
erwch	e^rwch
etblbli	e^t^blbl^i
etdbr	e^t^dbr
etebi	e^t^eb^i
etepki	e^t^epk^i
ethi	e^t^hi
etnixi	e^t^nix^i
etpsiqi	e^t^psiq^i
etqrai	e^t^qra^i
etrim	et^r^i^m
etspri	e^t^spr^i
etstir	e^t^stir
etwq	etwq
ewbb	ewbb
ewbr	ewbr
ewxv	ewxv
eyrwt	eyr^w^t
eyvpt	e^yvp^t
eywbd	e^ywbd
eywcmim	e^ywcm^i^m
eywd	e^ywd
gbwhh	gbwh^h
gbwr	gbwr
gdwlh	gdwl^h
ggwt	gg^w^t
gibwri	gbwr^i
glglim	glgl^i^m
glglt	glgl^t
glw	gl^w
gmwr	gmwr
gpn	gpn
grwn	gr^wn
grypsim	gryps^i^m
gwpiwt	gwp^i^wt
gwzzim	gwzz^i^m
gxliliwt	gxll^i^w^t
gzrh	gzr^h
gzwr	gzwr
hadwmh	h^adwm^h
hagwdl	h^a^gwdl
hagwzim	h^a^gwz^i^m
haibrim	h^a^ibr^i^m
halp	h^alp
haneim	h^an^e^i^m
hanvnh	h^anvn^h
hapwr	h^apwr
harc	h^arc
hargz	h^argz
harviq	h^arviq
harwk	h^arw^k
harwn	h^ar^wn
hath	h^at^h
hawirwn	h^awir^wn
hawkl	h^awkl
hawpnwy	h^awpnwy
hawzniim	h^awzn^ii^m
haxiwt	h^axi^w^t
hbatm	hbatm
hbdim	h^bd^i^m
hbgdim	h^bgd^i^m
hbvxti	h^bvx^ti
hbwilr	h^bwilr
hbwvni	h^bwvn^i
hcct	h^cc^t
hcddim	h^cdd^i^m
hciq	h^ciq
hclxt	h^clx^t
hcmaim	h^cma^i^m
hcwarwn	h^cwar^wn
hdbqwt	h^dbq^w^t
hdg	h^dg
hdlim	h^dl^i^m
hdliqw	h^dliq^w
hdwbh	h^dwb^h
hdwlpin	h^dwlpin
heart	h^ear^t
heimpnz	h^eimpnz^
hel	h^e^l
helg	h^elg
heme	h^eme
hemlwt	h^eml^w^t
heqiwt	heq^i^w^t
her	h^er
herwwl	h^erwwl
heti	h^eti
hetnh	he^tnh
hewbb	h^ewbb
hewqw	h^ewqw
hexwr	h^exwr
hggwt	h^gg^w^t
hgibwr	h^gibwr
hgiwni	hgiwni
hgiy	h^giy
hgml	h^gml
hgrynim	h^gryn^i^m
hgwyl	h^gwyl
hhcyh	h^hcy^h
hhptyh	h^hpty^h
hhtnemwiwt	h^hit^nemwi^w^t
hhtxiibwt	h^hit^xiib^wt
hiin	h^iin
hiitm	hii^tm
hirx	h^irx
hitwe	h^itwe
hixidh	h^ixd^h
hkabim	h^k^ab^i^m
hkdwr	h^kdwr
hkidwn	h^kidwn
hknisw	h^knis^w
hknti	hkn^ti
hkpwt	h^kp^w^t
hkrie	h^krie
hkwkbim	h^kwkb^i^m
hkwswt	h^kws^w^t
hkwwnh	h^kw^n^h
hkzh	h^kzh
hlnwx	h^l^nwx
hlwlah	h^lwla^h
hmebcwt	h^me^bc^w^t
hmexq	hm^exq
hmgek	h^mge^k
hmiqrwgl	h^miqrwgl
hmkwnh	h^m^kwnh
hmlch	h^mlc^h
hmpwrqim	h^m^pwrq^i^m
hmql	h^mql
hmqrim	h^m^qr^i^m
hmrbd	h^m^rbd
hmsdrwn	hm^sdr^wn
hmsmr	h^m^smr
hmt	h^mt
hmvava	h^mvava
hmwwt	h^mwt
hmxlh	h^m^xl^h
hmznwn	h^m^zn^wn
hndnd	h^ndnd
hndndwt	h^ndnd^w^t
hneim	h^ne^i^m
hnigwdim	h^nigwd^i^m
hnqniq	h^nqniq
hpazl	h^pazl
hpil	h^pil
hplt	h^^t
hplx	h^plx
hpntr	h^pntr
hprxh	h^prx^h
hptq	h^ptq
hpwkh	hpwk^h
hpxid	h^pxid^
hpzlim	h^pzl^i^m
hqiic	h^qiic
hqrnp	h^qrnp
hqvr	h^qvr
hqwbiwt	hqwb^i^w^t
hqwdm	h^qwdm
hqwr	h^qwr
hrgizw	h^rgiz^w
hrix	h^rix
hrqdnit	h^rqd^n^it
hs	hs
hsbr	hsbr
hsdin	h^sdin
hsimnim	h^simn^i^m
hsprim	h^spr^i^m
hstdrt	his^tdr^t
hstkli	hs^tkl^i
hstwbbw	hs^twbb^w
hswd	h^swd
hswkriih	h^swkr^ii^h
htblin	ht^blin
htlklk	ht^lkl^k
htnhg	ht^nhg
htprqh	ht^prq^h
htpwzim	h^tpwz^i^m
htrs	h^trs
htxilw	h^txil^w
htymlwt	ht^yml^wt
hvipvwpim	h^vipvwp^i^m
hvqsi	h^vqsi
hvrqvwr	h^vrqvwr
hvwsvr	h^vwsvr
hwcat	hwcat
hwps	hwps
hwrd	hwrd
hwwrwd	h^wrwd
hxdewt	h^xde^w^t
hxlqim	h^xlq^i^m
hxlwq	h^xlwq
hxmwdi	h^xmwd^i
hxmwdwt	h^xmwd^w^t
hxrwch	h^xrwc^h
hxzir	h^xzir
hycm	h^ycm
hygwl	h^ygwl
hyiniim	h^yin^ii^m
hyitwn	h^yit^wn
hyl	h^yl
hynqit	h^ynq^it
hyrb	h^yrb
hyrt	hyr^t
hywn	hy^^wn
hzat	h^zwat
hzbrh	h^zbr^
hzgwgit	h^zgwg^it
hzxl	h^zxl
hzzti	h^zz^ti
ibia	i^bia
icaw	i^caw
icib	i^cib
iclcl	i^clcl
icvnn	i^cv^nn
idhr	i^dhr
idlq	ii^dlq
idwy	idwy
iear	i^ear
iebrw	i^ebr^w
iebwr	i^ebwr
ienim	ien^i^m
ienti	ien^ti
igdlw	i^gdl^w
igidw	i^gid^w
igrd	i^grd
ikab	i^kab
iklh	ikl^h
iknsw	ii^kns^w
ikysw	ii^kys^w
ilklk	i^lkl^k
imeik	i^meik
ipriy	i^priy
ipwl	i^pwl
iqlqlw	i^qlql^w
iqrh	i^qr^h
ird	ird
irdm	i^rdm
irwqim	irwq^i^m
istwbb	is^twbb
itprq	it^prq
itxtn	it^xtn
ivrwp	i^vrwp
ixdh	ixd^h
ixid	ixid
ixkh	i^xkh
ixp	ixp
ixpwp	i^xpwp
iybrw	i^ybr^w
iyeh	i^yeh
iyip	i^yip
iylbw	i^ylb^w
izkh	i^zkh
kbdh	kbd^h
kbit	k^bi^t
kbwi	kbwi
keanxnw	k^e^anx^n^w
kecwmxwt	k^e^cwmx^w^t
kehiiti	k^e^hii^ti
kemdliqim	k^e^m^dliq^i^m
kemkim	k^e^mk^i^m
kemrbcim	k^e^m^rbc^i^m
kengmwr	k^e^n^gmwr
kepym	k^e^pym
ketlki	k^e^t^lk^i
ketsiimi	k^e^t^sim^i
kezh	k^e^zh
kisawt	kisa^w^t
kli	kli
klwmr	klwmr
kns^ti	kns^ti
kpiim	kp^ii^m
kpr	kpr^
krvis	krvis
ktb	ktb
ktm	ktm
ktr	ktr
kwby	kwby
kwll	kwll
kwlnw	kwl^n^w
kwtbim	kwtb^i^m
kysh	kys^h
ladwm	l^adwm
laibwd	l^aibwd
lailnwt	l^ailn^w^t
lamcy	l^amcy
lap	l^ap
larnb	l^a^rnb
larwn	l^ar^wn
lawr	l^awr
lawvwbws	l^awvwbws
laxwt	l^ax^wt
laz	l^az
lblwiim	l^blwi^i^m
lbnim	lbn^i^m
lbrwwz	l^brwz
lbwai	l^bwai
lcpcp	l^cpcp
lcwrh	l^cwr^h
lcycwyim	l^cycwy^i^m
ldbr	l^dbr
ldg	l^dg
ldgdg	l^dgdg
ldwd	l^dwd
leme	l^eme
lemwnh	l^emwn^h
lepni	l^epn^i
lewlxn	l^ewlx^n
lewpr	l^ewpr
lglid	l^glid^
lgwr	l^gwr
lhbia	l^hbia
lhelik	l^h^elik
lhibhb	l^h^bhb
lhicvnn	lhic^vnn
lhipcy	l^h^pcy
lhiwm	l^h^iwm
lhizhr	l^h^zhr
lhmvh	l^h^mv^h
lhn	l^hn
lhnix	l^h^nix
lhprid	l^h^prid
lhsbir	l^h^sbir
lhstdr	lhs^tdr
lhtpwcc	lht^pwcc
lhtxlq	l^ht^xlq
lhziz	l^hziz
lhzmin	l^h^zmin
li	l^i
libb	l^ibb
lidiim	l^id^ii^m
lie	l^ie
lki	lk^i
lkis	l^kis
lkisawt	l^kisa^w^t
lkn	lkn
lknsim	l^kn^s^i^m
lkp	l^kp
lkrim	l^kr^i^m
llb	l^lb
llprpr	l^l^prpr
lmbn	l^mbn
lmiim	l^miim
lmlbn	l^m^lbn
lmlkh	l^mlk^h
lmlwaim	l^m^lwa^i^m
lmqwm	l^m^qwm
lmsibh	l^m^sib^h
lmti	l^mti
lndndwt	l^ndnd^w^t
lneq	l^neq
lnkwn	l^nk^wn
lnmlh	l^nml^h
lnrwt	l^nr^w^t
lpqq	l^pqq
lpsntr	l^psntr
lqeqe	l^qeqe
lqrqs	l^qirqs
lqrr	l^qrr
lqwmh	l^qwm^h
lqxti	lqx^ti
lrgy	l^rgy
lrwc	l^rwc
lsbwnlhikns	l^sbwn^l^hi^kns
lsid	l^sid
lsndlim	l^sndl^i^m
lsws	l^sws
lteiyi	l^tey^i
ltiawr	l^tawr
ltlwt	l^tl^wt
ltwk	l^twk
ltwkim	l^twk^i^m
lvava	l^vava
lvil	l^vil
lviwl	l^viwl
lvlh	l^vlh
lwhlk	l^w^hlk
lwwrwd	l^wrwd
lwxct	lwxc^t
lxcwt	l^xc^wt
lxiig	l^xig
lxllit	l^xll^it
lxsidh	l^xsid^h
lxtwk	l^xtw^k
lxwre	l^xwre
lycmi	l^ycm^i
lyir	l^yir
lyl	l^yl
lywp	l^ywp
lyws	l^yws
lywzrt	l^ywzr^t
maizh	m^aizh
mambvih	m^ambv^i^h
mawnisivh	m^awn^isiv^h
mawxrt	m^awxr^t
maxwr	m^axwr
maxwri	m^axwr^i
mbah	m^ba^h
mbin	m^b^in
mbqet	m^bqe^t
mbrikh	m^brik^h
mbwgrt	m^bwgr^t
mcati	mca^t^i
mciq	m^ciq
mcirim	m^cir^i^m
mclcl	m^clcl
mclmt	m^clm^t
mclxim	m^clx^i^m
mclxwt	m^clx^w^t
mcvyrt	mc^vyr^t
mcwin	m^cwi^n
mcwir	m^cwir
md	md
mdbqwt	m^dbq^w^t
mdbrwt	m^dbr^w^t
mehw	meh^w
mepept	m^epep^t
meqpi	m^eqp^i
metlm	me^tlm
metmeim	me^tme^i^m
metyl	me^tyl
mevrh	me^vr^h
mewgy	m^ewgy
mewqw	mi^ewqw
mewtpt	m^ewtp^t
mewxrrt	m^ewxrr^t
mexq	m^exq
mgbrh	m^gbr^h
mgdl	m^gdl
mgieh	m^gie^h
mgirh	m^gir^h
mgnv	mgnv
mgpiim	mgp^ii^m
mgwb	m^gwb^
mhacbywt	m^h^acby^w^t
mhae	m^h^ae
mhaie	m^h^aie
mhalbwm	m^h^albwm
mhawirwn	m^h^awir^wn
mhawpnwy	m^h^awpnwy
mhdg	m^h^dg
mhdp	m^h^dp
mhdwrbn	m^h^dwrb^n
mherwtim	m^h^e^rwt^i^m
mhewq	m^h^ewq
mhewrh	m^h^ewr^h
mhhtxlh	m^h^htxl^h
mhkdwr	m^h^kdwr
mhkws	m^h^kws
mhm	m^hm
mhmdp	m^h^mdp
mhmedrim	m^h^medr^i^m
mhnr	m^h^nr
mhqliph	m^h^qlip^h
mhqwmqwm	m^h^qwmqwm
mhtqrh	m^h^tqr^h
mhxiim	m^h^xi^i^m
mhyiniim	m^h^yin^ii^m
mhyizim	m^h^yiz^i^m
mhyrish	m^h^yris^h
miim	mi^i^m
miqrwpwn	miqrwp^wn
miwxdt	m^iwxd^t
mkin	m^kin
mkirh	m^kir^h
mknh	m^kn^h
mknsiim	m^kns^ii^m
mknwt	m^kn^w^t
mkrim	m^kr^i^m
mksp	m^ksp
mktb	m^ktb
mkwn	m^kwn
mkwwc	m^kwc
mkxwlim	m^kxwl^i^m
mlbn	mlbn
mlmd	m^lmd
mlqqim	m^lqq^i^m
mlvpim	m^lvp^i^m
mlwxim	m^lwx^i^m
mmehw	m^m^e^hw
mmeik	m^meik
mnpnp	m^npnp
mph	mp^h
mprq	m^prq
mptxwt	m^ptx^w^t
mpwxit	mpwxit
mpwzrim	m^pwzr^i^m
mpxdim	m^pxd^i^m
mql	mql
mqwlpim	m^qwlp^i^m
mrah	m^ra^h
mrxrx	m^rxrx
mrxt	mrx^t
msbirh	m^sbir^h
msbirim	m^sbir^i^m
msbrsim	m^sbrs^i^m
mspr	m^spr
msprim	m^spr^i^m
mstlqim	m^stlq^i^m
msttrt	m^sttr^t
mstwbb	m^stwbb
mswbb	m^swbb
mswr	mswr
mt	mt
mtart	m^tart
mtgle	mt^gle
mthpk	mt^hpk
mtiibet	mt^iibe^t
mtlhbt	mt^lhb^t
mtlqqt	mt^lqq^t
mtndndim	mt^ndnd^i^m
mtnqh	mt^nqh
mtrgz	mt^rgz
mtwqn	m^twqn
mtx	^mtx
mtxbawt	mt^xba^w^t
mvil	m^vil
mvis	m^vis
mvriqw	mvriqw
mwbilh	mwbl^h
mwbnim	mwbn^i^m
mwca	mwca
mwcaim	mwca^i^m
mweiv	mweiv
mwelk	mw^el^k
mwnx	mwnx
mxbrim	m^xbr^i^m
mxbwaim	mxbwaim
mxwm	m^xwm
mycbnt	m^ycbn^t
mygbniih	m^ygb^n^i^ih
mygbniwt	m^ygb^n^i^w^t
myl	m^yl
mylit	myl^it
myrwk	m^yrwk
mzkwkit	m^zkwk^it
mzmin	m^zmin
n	nist^h
ndmh	ndmh
ndndwt	ndnd^w^t
neim	n^e^i^m
neiqh	n^eiq^h
ngwdim	ngwd^i^m
nhdrt	nhdr^t
nhih	n^hih
nilwn	ni^lwn
niqth	ni^qth
nlbie	n^lbie
nmcat	n^mca^t
nnix	n^nix
nnsh	n^nsh
nnyil	n^nyil
nprws	n^prws
nqbh	n^qb^h
nrbic	n^rbic
nrib	n^rib
nrxwc	n^rxwc
nsdr	n^sdr
ntnh	ntn^h
ntpsh	n^tps^h
ntqyh	n^tqy^h
ntxil	n^txil
nwdniq	nwd^niq
nwdniqit	nwdniq^it
nwea	nw^ea
nwemt	nw^em^t
nwhg	nw^hg
nwplt	nw^plt^k^h
nwsyim	nwsy^i^m
nwsywt	nwsy^w^t
nwtn	nw^tn
nx	nx^
nxbr	n^xbr
nxeb	n^xeb
nxewb	n^xewb
nxnq	n^xnq
nyeh	nyeh
nylh	n^ylh
nylm	nylm
nylmw	n^ylm^w
nymh	n^ym^h
nzhrh	nzhr^h
nzkrh	nzkr^h
nzmin	n^zmin
nzrqw	ni^zrq^w
pge	pge
pget	pge^t
pgew	pge^w
pizit	piz^i^t
pntr	pntr
pqidh	pqid^h
pqx	pqx
prq	prq
pt	p^^t
ptitim	pt^t^i^m
ptwx	ptwx
ptwxim	ptwx^i^m
ptxnw	ptx^n^w
pvie	pvie
pvipwn	pvip^wn
pwmlit	pwmlit
pwxd	pwxd
pxdh	pxd^h
qch	qch
qcp	qcp
qeqew	qeqe^w
qewrh	qewr^h
qiblh	qibl^h
qilpt	qipl^t
qiplt	qipl^t
qlql	qilql
qmt	qm^t
qpcnw	qpc^n^w
qpct	qpc^t
qqh	qq^h
qrwb	qrwb
qrwnwt	qrwn^w^t
qsvniivwt	qsvniiv^w^t
qw	qw
qweiwt	qwe^i^w^t
qwmi	qwm^i
qwr	qwr
qwrim	qwr^i^m
qwsm	qwsm
qyrh	qyr^h
rainw	rai^n^w
rcim	rc^i^m
rcit	rci^t
rcnw	rc^n^w
remh	rem^h
rgliik	rgl^i^ik
rgliim	rgl^ii^m
rkbt	rkb^t
rqpwt	rqp^w^t
rqvh	rqv^h
rsq	rsq
rvwbwt	rvwb^w^t
rwcwt	rwc^w^t
rwpa	rwpa
rwvb	rwvb
rxwb	rxwb
rxwq	rxwq
ryen	rye^n
ryl	ryl
sbibwn	sbib^wn
sdin	sdin
sgrw	sgr^w
sgwlwt	sgwl^w^t
sgwr	sgwr
si	s^i
simn	sim^n
slil	slil
sndlrim	sndlr^i^m
sp	sp
sprh	spr^h
swbbh	swbb^h
swdwt	swd^w^t
swpr	swpr
swpw	swp^w
swsim	sws^i^m
swtmt	swtm^t
swverv	swverv
t^lbe	t^lbe
tabwn	t^abwn
tbin	t^bin
tbkh	t^bkh
tcpcp	t^cpcp
tcyqi	t^cyq^i
tdagi	t^dag^i
tdbiqi	t^dbiq^i
tdliq	t^dliq
teali	t^eal^i
teim	t^e^i^m
teir	t^eir
temx	t^emx
teth	t^eth
teyh	tey^h
tglgl	^tglgl
tgzimi	t^gzim^i
tie	tie
tisy	t^sy
tkys	t^kys
tkysi	t^kys^i
tlmdi	t^lmd^i
tlqqi	t^lqq^i
tltl	tltl
tmddi	t^mdd^i
tngni	t^ngn^i
tpgei	t^pge^i
tprqi	t^prq^i
tptxi	t^ptx^i
tpwzim	tpwz^i^m
tqeibi	t^qeib^i
tqlql	t^qlql
tqrbi	t^qrb^i
tqrh	t^qr^h
trixi	t^rix^i
trwci	t^rwc^i
trwph	trwp^h
tsrq	t^srq
ttni	tt^n^i
ttpsi	t^tps^i
ttqrr	tt^qrr
tvxwr	t^bxwr
twaklw	tw^akl^w
twkim	twk^i^m
twkl	tw^kl
twpsim	twps^i^m
txnh	tx^n^h
txpwp	t^xpwp
txtki	t^xtk^i
tyei	t^ye^i
tyir	t^yir
tyiri	t^yir^i
tyrbb	t^y^rbb
vbx	vbx
vlpwn	vlpwn
vmnw	vm^n^w
vwblt	vwbl^t
vweim	vwe^i^m
wacby	w^acby
wadmh	w^adm^h
wah	w^ah
waizh	w^aizh
wamrh	w^amr^h
waneim	w^an^e^i^m
wanyl	w^a^nyil
waps	w^aps
waswr	w^aswr
waw	waw
wawli	w^awli
wawmrim	w^awmr^i^m
waxr	w^axr
wba	w^ba
wbcl	w^b^cl
wcpwr	w^cpwr
wcrxh	w^crx^h
wdqim	w^dq^i^m
wehih	w^e^hih
wehwa	w^e^hwa
weme	w^eme
wenirwt	w^ir^w^t
wewal	w^ewal
wewvp	w^ewvp
wgm	w^gm
wgmrnw	w^gmr^n^w
whaieh	w^h^aie^h
whapwr	w^h^apwr
whbqbwq	w^h^bqbwq
whcipwr	w^h^cipwr
whcipwrim	w^h^cipwr^i^m
whgim	whg^i^m
whidiyh	w^h^idy^h
whikn	w^hik^n
whkpit	w^h^kp^it
whqc	w^h^qc
whstklti	w^h^s^tkl^ti
whsws	w^h^sws
whtprq	w^h^tprq
whtyvet	w^hi^tyve^t
whzxl	w^h^zxl
wica	w^ica
wilk	w^ilk
wiwtr	w^iwtr
wketgmri	w^k^e^t^gmr^i
wklwm	w^klwm
wkwl	w^kwl
wkwlnw	w^kwln^w
wkzh	w^kzh
wla	w^la
wlbit	w^l^bit
wldlqt	w^l^dlq^t
wlepwk	w^l^epw^k
wlicn	w^l^ic^n
wlildh	w^l^ild^h
wlkn	w^lkn
wlmiim	w^l^miim
wlqev	w^l^qev
wltpws	w^l^tpws
wmaimt	w^m^aim^t
wmknisim	w^m^knis^i^m
wmlppwn	w^m^lpp^wn
wmrgeh	w^m^rge^h
wmrkbh	w^m^rkb^h
wmswdr	w^m^swdr
wmtwqh	w^m^twq^h
wmxk	w^m^xk
wnbqr	w^n^bqr
wnclh	w^ncl^h
wndbr	w^n^dbr
wnebrh	w^nebr^h
wniewqim	w^niewq^i^m
wnpl	w^npl
wnplw	w^npl^w
wnpwl	wn^pwl
wnqi	w^nq^i
wnra	w^n^ra
wntn	w^n^tn
wnwra	w^nwra
wnyim	w^nyim
wplim	wpl^i^m
wpr	w^pr
wqiblh	w^qibl^h
wqw	w^qw
wqx	w^qx
wrbyi	w^rby^i
wrkbt	w^rkb^t
wrqiq	w^rqiq
wrwqdim	w^rwqd^i^m
wsrv	w^srv
wtbiai	wt^biai
wtciiri	w^t^ciir^i
wtekbi	w^t^ekb^i
wtetqi	w^t^etq^i
wtetw	w^t^et^w
wtlqq	w^t^lqq
wtmtxi	w^t^mtx^i
wtngbi	w^t^ngb^i
wtqlivi	w^t^qliv^i
wtrngwl	w^trngwl
wtsdri	w^t^sdr^i
wttni	w^t^tn^i
wtzrqi	w^t^zrq^i
wvwb	w^vwb
wxebti	w^xeb^ti
wxipeti	w^xipe^ti
wxlq	w^xlq
wxwsmwt	w^xwsm^w^t
wycim	w^yc^i^m
wyd	w^yd
wyerim	w^yer^i^m
wykeiw	w^ykeiw
wyweh	w^yweh
wyzh	w^yz^h
wzw	w^zw
xbl	xbl
xc	xc
xcr	xcr
xewd	xewd
xidqim	xidq^i^m
xikit	xiki^t
xilim	xi^l^i^m
xitwl	xitwl
xkmh	xkm^h
xmah	xma^h
xnih	xni^h
xpph	xpp^h
xppt	xpp^t
xric	xric
xtwlim	xtwl^i^m
xvp	xvp
xwbh	xwb^h
xwlcwt	xwlc^w^t
xwlh	xwlh
xwmrim	xwm^r^i^m
xwreh	xwre^h
xwrim	xwr^i^m
xwtkim	xwtk^i^m
xzq	xzq
xzrti	xzr^ti
ybdt	ybd^t
ybh	ybh
ybrw	ybr^w
yc	yc
ycmi	ycm^i
yd	yd
yer	yer
ygbniih	ygb^n^ii^h
yglgl	yglgl
yglh	ygl^h
yin	yin
yinik	yin^i^k
yinw	yin^w
yl	yl
ylh	yl^h
ylih	yl^ih^
ylihn	yl^i^hn
ylik	yl^i^k
ylikm	yl^i^k^m
ylim	yl^i^m
yliwn	yli^wn
ylizh	yliz^h
ylth	ylt^h
ylwl	ylwl
ymdh	ymd^h
ymdt	ymd^t
ymq	ymq
ypw	yp^w
yqenit	yqe^n^i^t
yswq	yswq
ywgiwt	ywg^i^w^t
ywgn	ywgn
ywlm	ywlm
ywmdim	ywmd^i^m
ywzr	ywzr
yz	yz
yzb	yzb
zbrwt	zbr^w^t
zbwb	zbwb
zhr	zhr
zrqt	zrqtm
zwg	zwg
zwlgwt	zwlg^w^t
zwxl	zwxl
